Name,Year,Popularity,Name,Year,Popularity,diff
Colton,1980,5789,Colton,2009,149,-5640
Aidan,1980,5691,Aidan,2009,109,-5582
Rowan,1980,5772,Rowan,2009,445,-5327
Skylar,1980,5498,Skylar,2009,313,-5185
Macy,1980,5615,Macy,2009,571,-5044
Kiara,1980,5588,Kiara,2009,568,-5020
Rylan,1980,5332,Rylan,2009,320,-5012
Kyler,1980,5497,Kyler,2009,511,-4986
Lexi,1980,5505,Lexi,2009,537,-4968
Lilah,1980,5604,Lilah,2009,722,-4882
Aliyah,1980,5186,Aliyah,2009,351,-4835
Matteo,1980,5753,Matteo,2009,957,-4796
Bailey,1980,4925,Bailey,2009,186,-4739
Mila,1980,5621,Mila,2009,900,-4721
Kale,1980,5745,Kale,2009,1071,-4674
Makayla,1980,4799,Makayla,2009,128,-4671
Aria,1980,5535,Aria,2009,961,-4574
Griffin,1980,5009,Griffin,2009,439,-4570
Norah,1980,5230,Norah,2009,672,-4558
Kenzie,1980,5408,Kenzie,2009,857,-4551
Jayleen,1980,5575,Jayleen,2009,1040,-4535
Walker,1980,5490,Walker,2009,967,-4523
Reese,1980,4735,Reese,2009,264,-4471
Jaycee,1980,5573,Jaycee,2009,1102,-4471
Dakota,1980,4702,Dakota,2009,282,-4420
Cooper,1980,4552,Cooper,2009,137,-4415
Aden,1980,4909,Aden,2009,497,-4412
Nasir,1980,5352,Nasir,2009,965,-4387
Abril,1980,5519,Abril,2009,1154,-4365
Paxton,1980,4972,Paxton,2009,642,-4330
Serenity,1980,4538,Serenity,2009,213,-4325
Mateo,1980,4726,Mateo,2009,434,-4292
Cherish,1980,5545,Cherish,2009,1267,-4278
Tate,1980,5077,Tate,2009,902,-4175
Ryland,1980,5333,Ryland,2009,1184,-4149
Bella,1980,4295,Bella,2009,156,-4139
Ronan,1980,5302,Ronan,2009,1187,-4115
Anabella,1980,5528,Anabella,2009,1441,-4087
Fernanda,1980,4611,Fernanda,2009,527,-4084
Ace,1980,5331,Ace,2009,1262,-4069
Matthias,1980,5754,Matthias,2009,1699,-4055
Leighton,1980,5106,Leighton,2009,1055,-4051
Luna,1980,4640,Luna,2009,646,-3994
Emely,1980,4608,Emely,2009,616,-3992
Gisselle,1980,5200,Gisselle,2009,1244,-3956
Payton,1980,4070,Payton,2009,155,-3915
Eloise,1980,5562,Eloise,2009,1685,-3877
Arely,1980,5028,Arely,2009,1164,-3864
Karlie,1980,5582,Karlie,2009,1730,-3852
Sienna,1980,4262,Sienna,2009,416,-3846
Giovanny,1980,5280,Giovanny,2009,1455,-3825
Kellen,1980,4721,Kellen,2009,897,-3824
Braxton,1980,4101,Braxton,2009,321,-3780
Kaila,1980,5579,Kaila,2009,1799,-3780
Isabelle,1980,4005,Isabelle,2009,228,-3777
Dayana,1980,4599,Dayana,2009,822,-3777
Miracle,1980,4651,Miracle,2009,879,-3772
Reece,1980,4484,Reece,2009,719,-3765
Chandler,1980,4699,Chandler,2009,937,-3762
Kameron,1980,4239,Kameron,2009,522,-3717
Keira,1980,4025,Keira,2009,315,-3710
Anahi,1980,4584,Anahi,2009,881,-3703
Drake,1980,4089,Drake,2009,433,-3656
Savannah,1980,3756,Savannah,2009,115,-3641
Kallie,1980,4982,Kallie,2009,1353,-3629
Kianna,1980,5587,Kianna,2009,1965,-3622
Kaley,1980,5401,Kaley,2009,1809,-3592
Julien,1980,4719,Julien,2009,1139,-3580
Messiah,1980,4889,Messiah,2009,1344,-3545
Hadassah,1980,5201,Hadassah,2009,1656,-3545
Adeline,1980,4225,Adeline,2009,686,-3539
Millie,1980,5043,Millie,2009,1530,-3513
Giana,1980,4612,Giana,2009,1106,-3506
Lauryn,1980,4386,Lauryn,2009,885,-3501
Ellie,1980,3809,Ellie,2009,319,-3490
Cheyanne,1980,4592,Cheyanne,2009,1107,-3485
Taniya,1980,5050,Taniya,2009,1566,-3484
Marquez,1980,5752,Marquez,2009,2269,-3483
Ashlyn,1980,3799,Ashlyn,2009,323,-3476
Joselyn,1980,4109,Joselyn,2009,670,-3439
Keeley,1980,5362,Keeley,2009,1926,-3436
Markell,1980,5751,Markell,2009,2332,-3419
Malachi,1980,3691,Malachi,2009,306,-3385
Kalyn,1980,5402,Kalyn,2009,2021,-3381
Darien,1980,5348,Darien,2009,1968,-3380
Zaira,1980,5688,Zaira,2009,2319,-3369
Kairi,1980,5351,Kairi,2009,2000,-3351
Ellery,1980,5720,Ellery,2009,2373,-3347
Grayson,1980,3648,Grayson,2009,309,-3339
Bryanna,1980,4491,Bryanna,2009,1173,-3318
Amirah,1980,4800,Amirah,2009,1485,-3315
Halle,1980,4321,Halle,2009,1008,-3313
Kiera,1980,3942,Kiera,2009,669,-3273
Yuridia,1980,5687,Yuridia,2009,2416,-3271
Charlee,1980,4591,Charlee,2009,1323,-3268
Heaven,1980,3819,Heaven,2009,555,-3264
Axel,1980,3774,Axel,2009,516,-3258
Quinten,1980,5133,Quinten,2009,1878,-3255
Brooklyn,1980,3364,Brooklyn,2009,112,-3252
Lilly,1980,3497,Lilly,2009,260,-3237
Landry,1980,4787,Landry,2009,1550,-3237
Jericho,1980,5741,Jericho,2009,2506,-3235
Zainab,1980,5260,Zainab,2009,2045,-3215
Rohan,1980,4318,Rohan,2009,1120,-3198
Anabelle,1980,4227,Anabelle,2009,1033,-3194
Tegan,1980,4683,Tegan,2009,1493,-3190
Genesis,1980,3379,Genesis,2009,197,-3182
Yousef,1980,5318,Yousef,2009,2145,-3173
Vivianna,1980,5444,Vivianna,2009,2272,-3172
Felicity,1980,4610,Felicity,2009,1446,-3164
Aleah,1980,4124,Aleah,2009,978,-3146
Amara,1980,4226,Amara,2009,1091,-3135
Gianni,1980,4170,Gianni,2009,1054,-3116
Leyla,1980,4510,Leyla,2009,1395,-3115
Sage,1980,3719,Sage,2009,618,-3101
Nikolai,1980,4730,Nikolai,2009,1634,-3096
Ashton,1980,3269,Ashton,2009,194,-3075
Adriel,1980,4122,Adriel,2009,1069,-3053
Hayden,1980,3124,Hayden,2009,90,-3034
Liberty,1980,4006,Liberty,2009,973,-3033
Laila,1980,3319,Laila,2009,300,-3019
Alondra,1980,3483,Alondra,2009,469,-3014
Isabell,1980,4503,Isabell,2009,1490,-3013
Emelia,1980,4607,Emelia,2009,1595,-3012
Raelynn,1980,4528,Raelynn,2009,1523,-3005
Mckenzie,1980,3342,Mckenzie,2009,341,-3001
Dayton,1980,4073,Dayton,2009,1076,-2997
Shaila,1980,5653,Shaila,2009,2662,-2991
Isabella,1980,2985,Isabella,2009,1,-2984
Haven,1980,3881,Haven,2009,923,-2958
Slade,1980,5108,Slade,2009,2150,-2958
Khadija,1980,5586,Khadija,2009,2634,-2952
Otto,1980,5295,Otto,2009,2364,-2931
Calli,1980,5495,Calli,2009,2580,-2915
Karlee,1980,4129,Karlee,2009,1238,-2891
Maryjane,1980,4517,Maryjane,2009,1629,-2888
Milan,1980,4084,Milan,2009,1207,-2877
Trevon,1980,4280,Trevon,2009,1414,-2866
Bria,1980,4425,Bria,2009,1560,-2865
Jensen,1980,4715,Jensen,2009,1854,-2861
Lorelei,1980,3960,Lorelei,2009,1115,-2845
Aiyana,1980,3951,Aiyana,2009,1113,-2838
Heidy,1980,4615,Heidy,2009,1800,-2815
Soren,1980,4371,Soren,2009,1578,-2793
Ema,1980,5563,Ema,2009,2774,-2789
Corbin,1980,3309,Corbin,2009,543,-2766
Mira,1980,4208,Mira,2009,1445,-2763
Isai,1980,4468,Isai,2009,1712,-2756
Melia,1980,5420,Melia,2009,2672,-2748
King,1980,3697,King,2009,954,-2743
Scarlet,1980,3852,Scarlet,2009,1112,-2740
Madeleine,1980,3375,Madeleine,2009,657,-2718
Emery,1980,3256,Emery,2009,541,-2715
Kamaria,1980,5580,Kamaria,2009,2868,-2712
Seamus,1980,4422,Seamus,2009,1734,-2688
Aaliyah,1980,2838,Aaliyah,2009,161,-2677
Gianna,1980,2858,Gianna,2009,181,-2677
Aubree,1980,3234,Aubree,2009,572,-2662
Janaya,1980,5205,Janaya,2009,2554,-2651
Kiersten,1980,4027,Kiersten,2009,1380,-2647
Jovany,1980,4718,Jovany,2009,2077,-2641
Emerson,1980,2999,Emerson,2009,428,-2571
Eden,1980,2960,Eden,2009,401,-2559
Connor,1980,2617,Connor,2009,72,-2545
Evangeline,1980,3373,Evangeline,2009,828,-2545
Charli,1980,4439,Charli,2009,1908,-2531
Cordelia,1980,4930,Cordelia,2009,2400,-2530
Tyrese,1980,4358,Tyrese,2009,1831,-2527
Maximilian,1980,3510,Maximilian,2009,996,-2514
Alayna,1980,3074,Alayna,2009,561,-2513
Johan,1980,3519,Johan,2009,1007,-2512
Elina,1980,4604,Elina,2009,2097,-2507
Jacoby,1980,3419,Jacoby,2009,924,-2495
Brodie,1980,3528,Brodie,2009,1037,-2491
Isac,1980,5735,Isac,2009,3248,-2487
Asher,1980,2790,Asher,2009,304,-2486
Milo,1980,3424,Milo,2009,947,-2477
Hailey,1980,2554,Hailey,2009,92,-2462
Kade,1980,3292,Kade,2009,843,-2449
Keila,1980,4445,Keila,2009,2024,-2421
Lianna,1980,4449,Lianna,2009,2032,-2417
Lucie,1980,5419,Lucie,2009,3003,-2416
Kaitlyn,1980,2576,Kaitlyn,2009,166,-2410
Matilda,1980,3839,Matilda,2009,1438,-2401
Diamond,1980,3332,Diamond,2009,934,-2398
Eliel,1980,5718,Eliel,2009,3331,-2387
Dalton,1980,2847,Dalton,2009,464,-2383
Mayte,1980,4648,Mayte,2009,2265,-2383
Caitlyn,1980,2910,Caitlyn,2009,528,-2382
Zack,1980,4479,Zack,2009,2100,-2379
Kiran,1980,5131,Kiran,2009,2766,-2365
Tucker,1980,2788,Tucker,2009,426,-2362
Lucero,1980,4206,Lucero,2009,1844,-2362
Cain,1980,4551,Cain,2009,2189,-2362
Brody,1980,2479,Brody,2009,121,-2358
Ember,1980,3957,Ember,2009,1608,-2349
Jakob,1980,3005,Jakob,2009,659,-2346
Carter,1980,2411,Carter,2009,70,-2341
Layne,1980,3649,Layne,2009,1309,-2340
Nadya,1980,5629,Nadya,2009,3290,-2339
Willow,1980,2949,Willow,2009,614,-2335
Vida,1980,5683,Vida,2009,3348,-2335
Kolby,1980,3710,Kolby,2009,1383,-2327
Sophie,1980,2491,Sophie,2009,165,-2326
Imani,1980,3116,Imani,2009,796,-2320
Angeles,1980,5530,Angeles,2009,3213,-2317
Darrion,1980,5458,Darrion,2009,3145,-2313
Nola,1980,4034,Nola,2009,1733,-2301
Jai,1980,4713,Jai,2009,2412,-2301
Mya,1980,2520,Mya,2009,222,-2298
Nehemiah,1980,3028,Nehemiah,2009,731,-2297
Jameson,1980,2921,Jameson,2009,636,-2285
Lluvia,1980,4638,Lluvia,2009,2353,-2285
Kinsey,1980,4134,Kinsey,2009,1861,-2273
Annabelle,1980,2601,Annabelle,2009,342,-2259
Ajay,1980,5262,Ajay,2009,3008,-2254
Matias,1980,3782,Matias,2009,1555,-2227
Adriano,1980,5690,Adriano,2009,3465,-2225
Camron,1980,3129,Camron,2009,932,-2197
Darby,1980,5380,Darby,2009,3200,-2180
Briseida,1980,5371,Briseida,2009,3193,-2178
Deondre,1980,5713,Deondre,2009,3536,-2177
Taj,1980,4279,Taj,2009,2114,-2165
Skyler,1980,2502,Skyler,2009,343,-2159
Natali,1980,4450,Natali,2009,2292,-2158
Veronika,1980,5682,Veronika,2009,3526,-2156
Jamia,1980,5036,Jamia,2009,2881,-2155
Leela,1980,5112,Leela,2009,2957,-2155
Lucian,1980,3423,Lucian,2009,1276,-2147
Tamia,1980,3453,Tamia,2009,1306,-2147
Eliana,1980,2551,Eliana,2009,408,-2143
Fiona,1980,2761,Fiona,2009,620,-2141
Gemma,1980,3189,Gemma,2009,1061,-2128
Lincoln,1980,2472,Lincoln,2009,346,-2126
Lilliana,1980,2863,Lilliana,2009,739,-2124
Piper,1980,2446,Piper,2009,324,-2122
Aubrie,1980,2959,Aubrie,2009,838,-2121
Truman,1980,4476,Truman,2009,2357,-2119
Maximiliano,1980,3121,Maximiliano,2009,1003,-2118
Madelyn,1980,2273,Madelyn,2009,157,-2116
Santino,1980,3564,Santino,2009,1466,-2098
Massimo,1980,4887,Massimo,2009,2795,-2092
Leigha,1980,3883,Leigha,2009,1797,-2086
Karol,1980,5211,Karol,2009,3130,-2081
Angus,1980,5264,Angus,2009,3184,-2080
Phoebe,1980,2713,Phoebe,2009,635,-2078
Jaci,1980,4762,Jaci,2009,2686,-2076
Luciana,1980,3320,Luciana,2009,1251,-2069
Raegan,1980,2801,Raegan,2009,738,-2063
Jace,1980,2362,Jace,2009,305,-2057
Keegan,1980,2466,Keegan,2009,415,-2051
Anjali,1980,3933,Anjali,2009,1888,-2045
Mariella,1980,4249,Mariella,2009,2217,-2032
Keziah,1980,4914,Keziah,2009,2889,-2025
Kelton,1980,4338,Kelton,2009,2325,-2013
Amaris,1980,3863,Amaris,2009,1852,-2011
Dandre,1980,4553,Dandre,2009,2549,-2004
Ava,1980,2019,Ava,2009,18,-2001
Alessandra,1980,2908,Alessandra,2009,907,-2001
Kieran,1980,3045,Kieran,2009,1056,-1989
Jazmine,1980,2442,Jazmine,2009,470,-1972
Kendal,1980,3434,Kendal,2009,1467,-1967
Zoe,1980,2094,Zoe,2009,133,-1961
Justyn,1980,5076,Justyn,2009,3122,-1954
Karli,1980,3724,Karli,2009,1784,-1940
Ulisses,1980,5783,Ulisses,2009,3844,-1939
Valeria,1980,2108,Valeria,2009,175,-1933
Arianna,1980,2077,Arianna,2009,145,-1932
Karon,1980,4881,Karon,2009,2951,-1930
Ivana,1980,4199,Ivana,2009,2271,-1928
Desean,1980,4793,Desean,2009,2873,-1920
Neva,1980,5631,Neva,2009,3721,-1910
Remy,1980,3545,Remy,2009,1636,-1909
Myles,1980,2427,Myles,2009,520,-1907
Cade,1980,2558,Cade,2009,658,-1900
Quadir,1980,5182,Quadir,2009,3284,-1898
Nailah,1980,4524,Nailah,2009,2632,-1892
Malina,1980,4512,Malina,2009,2621,-1891
Anderson,1980,2470,Anderson,2009,582,-1888
Thalia,1980,3560,Thalia,2009,1672,-1888
Penelope,1980,2402,Penelope,2009,521,-1881
Kodi,1980,5411,Kodi,2009,3543,-1868
Annika,1980,2687,Annika,2009,821,-1866
Koby,1980,4722,Koby,2009,2856,-1866
Ibrahim,1980,3050,Ibrahim,2009,1191,-1859
Liam,1980,1917,Liam,2009,67,-1850
Nathalie,1980,2778,Nathalie,2009,933,-1845
Emiliano,1980,2374,Emiliano,2009,531,-1843
Justus,1980,3521,Justus,2009,1681,-1840
Hana,1980,3382,Hana,2009,1546,-1836
Nova,1980,3726,Nova,2009,1891,-1835
Mckinley,1980,3164,Mckinley,2009,1339,-1825
Alessandro,1980,3211,Alessandro,2009,1392,-1819
Parker,1980,1942,Parker,2009,131,-1811
Priscila,1980,4009,Priscila,2009,2201,-1808
Misael,1980,3411,Misael,2009,1615,-1796
Natalee,1980,2765,Natalee,2009,970,-1795
Laina,1980,5593,Laina,2009,3799,-1794
Celine,1980,3661,Celine,2009,1869,-1792
Danika,1980,2685,Danika,2009,895,-1790
Lilian,1980,2623,Lilian,2009,834,-1789
Vania,1980,5680,Vania,2009,3893,-1787
Orion,1980,2874,Orion,2009,1093,-1781
Amira,1980,2692,Amira,2009,912,-1780
Keyonna,1980,5087,Keyonna,2009,3310,-1777
Valentina,1980,2208,Valentina,2009,437,-1771
Isha,1980,4021,Isha,2009,2259,-1762
Madelin,1980,5113,Madelin,2009,3351,-1762
Gian,1980,4558,Gian,2009,2803,-1755
Tatum,1980,2496,Tatum,2009,742,-1754
Gabriella,1980,1855,Gabriella,2009,104,-1751
Gracie,1980,2003,Gracie,2009,258,-1745
Mika,1980,4520,Mika,2009,2775,-1745
Kimber,1980,3685,Kimber,2009,1945,-1740
Nalani,1980,4282,Nalani,2009,2544,-1738
Sydney,1980,1872,Sydney,2009,138,-1734
Talya,1980,5670,Talya,2009,3942,-1728
Kaleb,1980,1915,Kaleb,2009,188,-1727
Kelsi,1980,4446,Kelsi,2009,2719,-1727
Zechariah,1980,3213,Zechariah,2009,1487,-1726
Naima,1980,3558,Naima,2009,1837,-1721
Andrei,1980,4695,Andrei,2009,2975,-1720
Noam,1980,5293,Noam,2009,3573,-1720
Kalen,1980,4564,Kalen,2009,2845,-1719
Yana,1980,5345,Yana,2009,3630,-1715
Ciara,1980,2419,Ciara,2009,709,-1710
Rania,1980,4844,Rania,2009,3134,-1710
Adonis,1980,3347,Adonis,2009,1640,-1707
Mina,1980,3228,Mina,2009,1522,-1706
Cambria,1980,3535,Cambria,2009,1830,-1705
Destini,1980,3548,Destini,2009,1851,-1697
Chloe,1980,1728,Chloe,2009,37,-1691
Silas,1980,2181,Silas,2009,491,-1690
Aliya,1980,2870,Aliya,2009,1185,-1685
Isis,1980,2805,Isis,2009,1134,-1671
Carlie,1980,2982,Carlie,2009,1311,-1671
Jude,1980,1996,Jude,2009,328,-1668
Aliza,1980,3155,Aliza,2009,1502,-1653
Blayne,1980,4349,Blayne,2009,2696,-1653
Riley,1980,1707,Riley,2009,57,-1650
Stefany,1980,4678,Stefany,2009,3028,-1650
Brenden,1980,2358,Brenden,2009,710,-1648
Ezekiel,1980,2074,Ezekiel,2009,427,-1647
Kenna,1980,2978,Kenna,2009,1342,-1636
Isiah,1980,2791,Isiah,2009,1156,-1635
Holland,1980,4560,Holland,2009,2926,-1634
Skye,1980,2546,Skye,2009,914,-1632
Eliot,1980,4053,Eliot,2009,2431,-1622
Layla,1980,1749,Layla,2009,130,-1619
Kai,1980,1984,Kai,2009,366,-1618
Linus,1980,5107,Linus,2009,3489,-1618
Ansley,1980,2831,Ansley,2009,1222,-1609
Marin,1980,3376,Marin,2009,1769,-1607
Dax,1980,3254,Dax,2009,1651,-1603
Essence,1980,3385,Essence,2009,1783,-1602
Violet,1980,1913,Violet,2009,314,-1599
Romeo,1980,2452,Romeo,2009,855,-1597
Ramses,1980,4316,Ramses,2009,2723,-1593
Carson,1980,1723,Carson,2009,134,-1589
Emilee,1980,2424,Emilee,2009,836,-1588
America,1980,2633,America,2009,1046,-1587
Yaritza,1980,3055,Yaritza,2009,1472,-1583
Chase,1980,1653,Chase,2009,86,-1567
Scarlett,1980,1934,Scarlett,2009,370,-1564
Dashawn,1980,3421,Dashawn,2009,1867,-1554
Paloma,1980,2890,Paloma,2009,1338,-1552
Abdullah,1980,3277,Abdullah,2009,1725,-1552
Bryson,1980,1827,Bryson,2009,277,-1550
Kali,1980,2494,Kali,2009,944,-1550
Trinity,1980,1719,Trinity,2009,177,-1542
Malky,1980,4838,Malky,2009,3296,-1542
Shimon,1980,3598,Shimon,2009,2064,-1534
Tyshawn,1980,3628,Tyshawn,2009,2095,-1533
Coleman,1980,3210,Coleman,2009,1680,-1530
Bennett,1980,2140,Bennett,2009,613,-1527
Elly,1980,4606,Elly,2009,3080,-1526
Brisa,1980,2600,Brisa,2009,1075,-1525
Kyra,1980,2070,Kyra,2009,548,-1522
Yehudis,1980,4858,Yehudis,2009,3336,-1522
Emmett,1980,2195,Emmett,2009,674,-1521
Carley,1980,2806,Carley,2009,1285,-1521
Ariella,1980,3105,Ariella,2009,1589,-1516
Carli,1980,3922,Carli,2009,2408,-1514
Musa,1980,4415,Musa,2009,2906,-1509
Channing,1980,3621,Channing,2009,2113,-1508
Avraham,1980,3820,Avraham,2009,2313,-1507
Mikhail,1980,4728,Mikhail,2009,3228,-1500
Brennon,1980,3873,Brennon,2009,2375,-1498
Kenan,1980,5062,Kenan,2009,3569,-1493
Estrella,1980,2294,Estrella,2009,806,-1488
Katelyn,1980,1684,Katelyn,2009,206,-1478
Braden,1980,1816,Braden,2009,344,-1472
Cullen,1980,2503,Cullen,2009,1032,-1471
Arlette,1980,4488,Arlette,2009,3019,-1469
Menachem,1980,3473,Menachem,2009,2011,-1462
Melany,1980,2280,Melany,2009,819,-1461
Maximillian,1980,3698,Maximillian,2009,2238,-1460
Moriah,1980,2872,Moriah,2009,1417,-1455
Emerald,1980,4019,Emerald,2009,2567,-1452
Mohamed,1980,2359,Mohamed,2009,908,-1451
Dahlia,1980,2709,Dahlia,2009,1259,-1450
Dallin,1980,4188,Dallin,2009,2740,-1448
Nevin,1980,4431,Nevin,2009,2987,-1444
Marek,1980,4285,Marek,2009,2844,-1441
Yazmin,1980,2810,Yazmin,2009,1371,-1439
Eliyahu,1980,4168,Eliyahu,2009,2730,-1438
Cassidy,1980,1935,Cassidy,2009,498,-1437
Gideon,1980,2578,Gideon,2009,1141,-1437
Annabell,1980,3745,Annabell,2009,2314,-1431
Malia,1980,1830,Malia,2009,406,-1424
Cristian,1980,1720,Cristian,2009,297,-1423
Kylee,1980,1750,Kylee,2009,327,-1423
Areli,1980,3233,Areli,2009,1810,-1423
Osiel,1980,4472,Osiel,2009,3050,-1422
Alexa,1980,1541,Alexa,2009,125,-1416
Shiloh,1980,2354,Shiloh,2009,941,-1413
Giancarlo,1980,2823,Giancarlo,2009,1418,-1405
Sebastian,1980,1509,Sebastian,2009,107,-1402
Lily,1980,1471,Lily,2009,73,-1398
Gia,1980,2515,Gia,2009,1117,-1398
Leena,1980,3925,Leena,2009,2527,-1398
Harrison,1980,1851,Harrison,2009,466,-1385
Giselle,1980,1682,Giselle,2009,298,-1384
Christofer,1980,4911,Christofer,2009,3529,-1382
Kaylene,1980,4630,Kaylene,2009,3252,-1378
Yael,1980,2973,Yael,2009,1596,-1377
Lila,1980,1737,Lila,2009,365,-1372
Kamil,1980,5177,Kamil,2009,3807,-1370
Rubi,1980,2889,Rubi,2009,1524,-1365
Ella,1980,1402,Ella,2009,54,-1348
Hallie,1980,2353,Hallie,2009,1011,-1342
Adrien,1980,2814,Adrien,2009,1474,-1340
Paulina,1980,2539,Paulina,2009,1205,-1334
Yusuf,1980,2917,Yusuf,2009,1584,-1333
Alexia,1980,1789,Alexia,2009,462,-1327
Maryam,1980,2979,Maryam,2009,1653,-1326
Kaycie,1980,5406,Kaycie,2009,4081,-1325
Neha,1980,3686,Neha,2009,2370,-1316
Jackelyn,1980,3683,Jackelyn,2009,2369,-1314
Ely,1980,3765,Ely,2009,2462,-1303
Brennan,1980,1752,Brennan,2009,457,-1295
Tristan,1980,1412,Tristan,2009,118,-1294
Miya,1980,3062,Miya,2009,1771,-1291
Juliette,1980,2146,Juliette,2009,861,-1285
Maxwell,1980,1516,Maxwell,2009,236,-1280
Julianna,1980,1690,Julianna,2009,410,-1280
Rowdy,1980,4141,Rowdy,2009,2861,-1280
Lane,1980,1882,Lane,2009,603,-1279
Houston,1980,3312,Houston,2009,2041,-1271
Cristopher,1980,2357,Cristopher,2009,1092,-1265
Joslyn,1980,2500,Joslyn,2009,1236,-1264
Reagan,1980,1534,Reagan,2009,271,-1263
Emmy,1980,2924,Emmy,2009,1661,-1263
Sarai,1980,2041,Sarai,2009,780,-1261
Jazmin,1980,1699,Jazmin,2009,443,-1256
Hanna,1980,2095,Hanna,2009,842,-1253
Yosef,1980,2852,Yosef,2009,1600,-1252
Delilah,1980,1659,Delilah,2009,411,-1248
Isa,1980,4382,Isa,2009,3135,-1247
Simcha,1980,4897,Simcha,2009,3654,-1243
Alec,1980,2081,Alec,2009,844,-1237
Cleo,1980,5547,Cleo,2009,4315,-1232
Sofia,1980,1342,Sofia,2009,113,-1229
Olin,1980,5761,Olin,2009,4533,-1228
August,1980,2084,August,2009,860,-1224
Illiana,1980,5391,Illiana,2009,4167,-1224
Hazel,1980,1810,Hazel,2009,588,-1222
Zeke,1980,4061,Zeke,2009,2839,-1222
Zaida,1980,4859,Zaida,2009,3640,-1219
Efraim,1980,4870,Efraim,2009,3655,-1215
Unique,1980,2907,Unique,2009,1697,-1210
Uriel,1980,2047,Uriel,2009,839,-1208
Yehuda,1980,3060,Yehuda,2009,1856,-1204
Ezra,1980,1692,Ezra,2009,494,-1198
Dulce,1980,1874,Dulce,2009,680,-1194
Diego,1980,1307,Diego,2009,120,-1187
Lola,1980,1651,Lola,2009,465,-1186
Ulises,1980,2450,Ulises,2009,1264,-1186
Paola,1980,1925,Paola,2009,741,-1184
Damarcus,1980,4466,Damarcus,2009,3283,-1183
Janay,1980,4506,Janay,2009,3326,-1180
Avery,1980,1257,Avery,2009,78,-1179
Lanie,1980,3795,Lanie,2009,2617,-1178
Dasha,1980,4076,Dasha,2009,2899,-1177
Wyatt,1980,1263,Wyatt,2009,87,-1176
Lukas,1980,1648,Lukas,2009,472,-1176
Mackenzie,1980,1345,Mackenzie,2009,182,-1163
Alina,1980,1681,Alina,2009,518,-1163
Ilan,1980,4172,Ilan,2009,3009,-1163
Emilia,1980,1955,Emilia,2009,793,-1162
Naila,1980,4942,Naila,2009,3784,-1158
Andi,1980,3999,Andi,2009,2852,-1147
Anika,1980,2187,Anika,2009,1042,-1145
Lizbeth,1980,1886,Lizbeth,2009,748,-1138
Grady,1980,1714,Grady,2009,577,-1137
Arielle,1980,2176,Arielle,2009,1039,-1137
Jackeline,1980,2963,Jackeline,2009,1826,-1137
Khalil,1980,2154,Khalil,2009,1018,-1136
Shalom,1980,4894,Shalom,2009,3758,-1136
Julissa,1980,1821,Julissa,2009,687,-1134
Camilla,1980,2147,Camilla,2009,1013,-1134
Mae,1980,3108,Mae,2009,1974,-1134
Oziel,1980,4473,Oziel,2009,3339,-1134
Hunter,1980,1210,Hunter,2009,79,-1131
Jordon,1980,3251,Jordon,2009,2121,-1130
Alden,1980,3003,Alden,2009,1880,-1123
Jada,1980,1378,Jada,2009,257,-1121
Dimitri,1980,3206,Dimitri,2009,2086,-1120
Zackary,1980,1866,Zackary,2009,747,-1119
Madeline,1980,1281,Madeline,2009,163,-1118
Samara,1980,2079,Samara,2009,963,-1116
Jackson,1980,1147,Jackson,2009,33,-1114
Jolie,1980,2370,Jolie,2009,1256,-1114
Deven,1980,2574,Deven,2009,1460,-1114
Ronaldo,1980,3243,Ronaldo,2009,2133,-1110
Leandro,1980,3006,Leandro,2009,1905,-1101
Marquise,1980,3032,Marquise,2009,1931,-1101
Rivky,1980,4392,Rivky,2009,3297,-1095
Ria,1980,3947,Ria,2009,2853,-1094
Sierra,1980,1503,Sierra,2009,412,-1091
Adrianna,1980,1463,Adrianna,2009,374,-1089
Leila,1980,1580,Leila,2009,492,-1088
Amina,1980,2403,Amina,2009,1319,-1084
Jairo,1980,2462,Jairo,2009,1378,-1084
Lillie,1980,1893,Lillie,2009,814,-1079
Daniella,1980,1693,Daniella,2009,615,-1078
Shyla,1980,2570,Shyla,2009,1492,-1078
Dillon,1980,1663,Dillon,2009,586,-1077
Valentino,1980,2698,Valentino,2009,1628,-1070
Favian,1980,4557,Favian,2009,3493,-1064
Lia,1980,1800,Lia,2009,737,-1063
Titus,1980,1961,Titus,2009,901,-1060
Sky,1980,2721,Sky,2009,1667,-1054
Tahir,1980,5312,Tahir,2009,4261,-1051
Giovanni,1980,1286,Giovanni,2009,238,-1048
Josiah,1980,1186,Josiah,2009,141,-1045
Mariam,1980,2268,Mariam,2009,1227,-1041
Trey,1980,1665,Trey,2009,626,-1039
Maximo,1980,2704,Maximo,2009,1678,-1026
Amir,1980,1577,Amir,2009,552,-1025
Aurelia,1980,2962,Aurelia,2009,1942,-1020
Brynn,1980,1700,Brynn,2009,681,-1019
Kalani,1980,3076,Kalani,2009,2059,-1017
Brantley,1980,3431,Brantley,2009,2414,-1017
Stella,1980,1295,Stella,2009,280,-1015
Juliana,1980,1349,Juliana,2009,336,-1013
Paris,1980,1774,Paris,2009,766,-1008
Sabine,1980,4162,Sabine,2009,3155,-1007
Cole,1980,1124,Cole,2009,127,-997
Kasandra,1980,3665,Kasandra,2009,2668,-997
Danna,1980,1767,Danna,2009,772,-995
Ahuva,1980,4813,Ahuva,2009,3818,-995
Avrohom,1980,3634,Avrohom,2009,2640,-994
Maia,1980,2110,Maia,2009,1118,-992
Charley,1980,2579,Charley,2009,1587,-992
Myranda,1980,5424,Myranda,2009,4432,-992
Tzvi,1980,3445,Tzvi,2009,2454,-991
Tyquan,1980,4293,Tyquan,2009,3303,-990
Mac,1980,4969,Mac,2009,3987,-982
Kody,1980,2221,Kody,2009,1241,-980
Alia,1980,2415,Alia,2009,1435,-980
Imran,1980,4219,Imran,2009,3239,-980
Zackery,1980,2464,Zackery,2009,1486,-978
Zane,1980,1424,Zane,2009,447,-977
Rey,1980,2878,Rey,2009,1902,-976
Cale,1980,2380,Cale,2009,1405,-975
Kabir,1980,4720,Kabir,2009,3746,-974
Muhammad,1980,2243,Muhammad,2009,1270,-973
Deja,1980,2763,Deja,2009,1791,-972
Camilo,1980,2875,Camilo,2009,1903,-972
Annabel,1980,2296,Annabel,2009,1327,-969
Gavin,1980,1011,Gavin,2009,47,-964
Sadie,1980,1213,Sadie,2009,250,-963
Cruz,1980,1662,Cruz,2009,699,-963
Patience,1980,2348,Patience,2009,1386,-962
Dontrell,1980,5103,Dontrell,2009,4141,-962
Daniela,1980,1264,Daniela,2009,303,-961
Janessa,1980,2005,Janessa,2009,1045,-960
Reem,1980,4791,Reem,2009,3835,-956
Janeth,1980,4201,Janeth,2009,3250,-951
Nikolas,1980,1879,Nikolas,2009,931,-948
Jasper,1980,1625,Jasper,2009,678,-947
Angelika,1980,5531,Angelika,2009,4584,-947
Uriah,1980,2194,Uriah,2009,1248,-946
Fletcher,1980,3007,Fletcher,2009,2061,-946
Davis,1980,1824,Davis,2009,883,-941
Danica,1980,1673,Danica,2009,733,-940
Chance,1980,1391,Chance,2009,452,-939
Cheyenne,1980,1334,Cheyenne,2009,397,-937
Yakov,1980,3446,Yakov,2009,2509,-937
Allana,1980,5527,Allana,2009,4590,-937
Alonso,1980,2308,Alonso,2009,1372,-936
Mason,1980,978,Mason,2009,49,-929
Kayla,1980,1037,Kayla,2009,110,-927
Isaias,1980,1948,Isaias,2009,1021,-927
Elyssa,1980,3070,Elyssa,2009,2143,-927
Denisse,1980,2888,Denisse,2009,1966,-922
Isaiah,1980,976,Isaiah,2009,59,-917
Malik,1980,1417,Malik,2009,502,-915
Xavier,1980,1017,Xavier,2009,103,-914
Lucille,1980,1975,Lucille,2009,1063,-912
Harris,1980,4171,Harris,2009,3259,-912
Kassandra,1980,1987,Kassandra,2009,1077,-910
Santiago,1980,1141,Santiago,2009,232,-909
Lipa,1980,5288,Lipa,2009,4380,-908
Roselyn,1980,2611,Roselyn,2009,1707,-904
Goldy,1980,4831,Goldy,2009,3930,-901
Owen,1980,970,Owen,2009,71,-899
Weston,1980,1428,Weston,2009,529,-899
Luciano,1980,2284,Luciano,2009,1388,-896
Vianey,1980,3556,Vianey,2009,2660,-896
Brigham,1980,4341,Brigham,2009,3445,-896
Natalia,1980,1128,Natalia,2009,235,-893
Elyse,1980,2098,Elyse,2009,1206,-892
Obed,1980,3914,Obed,2009,3023,-891
Juliet,1980,1521,Juliet,2009,632,-889
Yasmine,1980,2607,Yasmine,2009,1723,-884
Stephon,1980,3463,Stephon,2009,2581,-882
Landon,1980,924,Landon,2009,51,-873
Johann,1980,3208,Johann,2009,2335,-873
Omari,1980,2113,Omari,2009,1247,-866
Aurora,1980,1323,Aurora,2009,458,-865
Aharon,1980,4404,Aharon,2009,3540,-864
Harmony,1980,1386,Harmony,2009,526,-860
Emi,1980,3923,Emi,2009,3063,-860
Silvana,1980,5245,Silvana,2009,4386,-859
Kylie,1980,1016,Kylie,2009,160,-856
Mohammed,1980,2217,Mohammed,2009,1361,-856
Rishi,1980,3131,Rishi,2009,2276,-855
Ayanna,1980,2020,Ayanna,2009,1174,-846
Ariana,1980,1043,Ariana,2009,198,-845
Miles,1980,1138,Miles,2009,295,-843
Nia,1980,1759,Nia,2009,916,-843
Darian,1980,2242,Darian,2009,1399,-843
Stefano,1980,4898,Stefano,2009,4055,-843
Leilani,1980,1366,Leilani,2009,545,-821
Roman,1980,1203,Roman,2009,384,-819
Alexandria,1980,1240,Alexandria,2009,423,-817
Tatiana,1980,1523,Tatiana,2009,706,-817
Liliana,1980,1089,Liliana,2009,274,-815
Abram,1980,1818,Abram,2009,1005,-813
Baron,1980,3577,Baron,2009,2764,-813
Kaycee,1980,3195,Kaycee,2009,2384,-811
Nolan,1980,1027,Nolan,2009,217,-810
Royal,1980,3783,Royal,2009,2978,-805
Cy,1980,4785,Cy,2009,3982,-803
Quinn,1980,1169,Quinn,2009,369,-800
Javon,1980,1826,Javon,2009,1027,-799
Emory,1980,2197,Emory,2009,1402,-795
Rigo,1980,4571,Rigo,2009,3782,-789
Bronson,1980,2834,Bronson,2009,2046,-788
Jade,1980,1071,Jade,2009,285,-786
Asa,1980,1910,Asa,2009,1128,-782
Saira,1980,4258,Saira,2009,3479,-779
Kira,1980,1367,Kira,2009,590,-777
Eleanor,1980,1232,Eleanor,2009,460,-772
Shmuel,1980,3179,Shmuel,2009,2409,-770
Foster,1980,4054,Foster,2009,3287,-767
Mahmoud,1980,5132,Mahmoud,2009,4369,-763
Sana,1980,4079,Sana,2009,3318,-761
Cora,1980,1358,Cora,2009,599,-759
Fatima,1980,1313,Fatima,2009,557,-756
Karly,1980,2455,Karly,2009,1700,-755
Giovanna,1980,2206,Giovanna,2009,1453,-753
Jeramiah,1980,2528,Jeramiah,2009,1775,-753
Emma,1980,759,Emma,2009,8,-751
Oliver,1980,914,Oliver,2009,164,-750
Elaina,1980,1626,Elaina,2009,876,-750
Gerson,1980,3695,Gerson,2009,2949,-746
Ahmed,1980,1968,Ahmed,2009,1226,-742
Tobin,1980,3984,Tobin,2009,3242,-742
Ephraim,1980,3087,Ephraim,2009,2347,-740
Elinor,1980,4297,Elinor,2009,3557,-740
Karoline,1980,4626,Karoline,2009,3887,-739
Maya,1980,897,Maya,2009,159,-738
Breana,1980,3187,Breana,2009,2449,-738
Vladimir,1980,3156,Vladimir,2009,2419,-737
Mariana,1980,1197,Mariana,2009,461,-736
Tanner,1980,1022,Tanner,2009,292,-730
Rhianna,1980,2604,Rhianna,2009,1874,-730
Leyna,1980,5041,Leyna,2009,4313,-728
Gus,1980,3709,Gus,2009,2982,-727
Ezequiel,1980,1931,Ezequiel,2009,1209,-722
Estelle,1980,3323,Estelle,2009,2601,-722
Ameer,1980,3132,Ameer,2009,2413,-719
Logan,1980,740,Logan,2009,22,-718
Breanna,1980,1151,Breanna,2009,435,-716
Mariah,1980,917,Mariah,2009,204,-713
Dani,1980,2717,Dani,2009,2004,-713
Callie,1980,1221,Callie,2009,510,-711
Waverly,1980,5502,Waverly,2009,4793,-709
Collin,1980,948,Collin,2009,240,-708
Leland,1980,1410,Leland,2009,707,-703
Destiny,1980,855,Destiny,2009,154,-701
Anisa,1980,3223,Anisa,2009,2522,-701
Taliah,1980,3592,Taliah,2009,2891,-701
Duncan,1980,2275,Duncan,2009,1575,-700
Iman,1980,3239,Iman,2009,2545,-694
Rony,1980,4892,Rony,2009,4198,-694
Donavon,1980,4555,Donavon,2009,3869,-686
Rocco,1980,1480,Rocco,2009,795,-685
Yuri,1980,4043,Yuri,2009,3360,-683
Mattie,1980,2244,Mattie,2009,1564,-680
Gavriel,1980,4410,Gavriel,2009,3731,-679
Keyon,1980,2731,Keyon,2009,2055,-676
Lillian,1980,772,Lillian,2009,97,-675
Kaitlin,1980,1741,Kaitlin,2009,1066,-675
Yasmin,1980,1591,Yasmin,2009,918,-673
Carmella,1980,3456,Carmella,2009,2783,-673
Jaren,1980,3843,Jaren,2009,3170,-673
Enoch,1980,3249,Enoch,2009,2577,-672
Lucius,1980,4056,Lucius,2009,3385,-671
Astrid,1980,2871,Astrid,2009,2204,-667
Jaqueline,1980,1944,Jaqueline,2009,1278,-666
Clare,1980,1959,Clare,2009,1294,-665
Sophia,1980,677,Sophia,2009,13,-664
Emilio,1980,1290,Emilio,2009,627,-663
Jonah,1980,932,Jonah,2009,270,-662
Belen,1980,2246,Belen,2009,1585,-661
Keren,1980,3334,Keren,2009,2673,-661
Asia,1980,1559,Asia,2009,899,-660
Rian,1980,3138,Rian,2009,2478,-660
Julisa,1980,3664,Julisa,2009,3004,-660
Antonella,1980,3152,Antonella,2009,2493,-659
Reid,1980,1356,Reid,2009,698,-658
Ashly,1980,2368,Ashly,2009,1711,-657
Anastasia,1980,1297,Anastasia,2009,641,-656
Elsie,1980,1914,Elsie,2009,1261,-653
Lucien,1980,3353,Lucien,2009,2700,-653
Avi,1980,3308,Avi,2009,2656,-652
Marcello,1980,2996,Marcello,2009,2345,-651
Eliza,1980,1205,Eliza,2009,558,-647
Yisrael,1980,5316,Yisrael,2009,4670,-646
Leonardo,1980,947,Leonardo,2009,302,-645
Travon,1980,3079,Travon,2009,2434,-645
Elias,1980,930,Elias,2009,289,-641
Mordechai,1980,2751,Mordechai,2009,2117,-634
Benson,1980,2824,Benson,2009,2192,-632
Lucy,1980,860,Lucy,2009,230,-630
Mikael,1980,3767,Mikael,2009,3139,-628
Katya,1980,4629,Katya,2009,4001,-628
Ethan,1980,630,Ethan,2009,3,-627
Major,1980,2886,Major,2009,2262,-624
Max,1980,800,Max,2009,180,-620
Emmanuel,1980,887,Emmanuel,2009,267,-620
Dovid,1980,3636,Dovid,2009,3016,-620
Josue,1980,971,Josue,2009,353,-618
Yisroel,1980,2666,Yisroel,2009,2052,-614
Rodrigo,1980,1380,Rodrigo,2009,769,-611
Elliot,1980,1157,Elliot,2009,547,-610
Devan,1980,2214,Devan,2009,1606,-608
Colby,1980,1171,Colby,2009,564,-607
Wynter,1980,2868,Wynter,2009,2261,-607
Ani,1980,3921,Ani,2009,3315,-606
Cal,1980,4335,Cal,2009,3730,-605
Mia,1980,644,Mia,2009,41,-603
Eli,1980,746,Eli,2009,143,-603
Adan,1980,1188,Adan,2009,585,-603
Mendel,1980,3823,Mendel,2009,3223,-600
Reed,1980,1459,Reed,2009,864,-595
Sanjay,1980,3971,Sanjay,2009,3376,-595
Kyla,1980,1131,Kyla,2009,539,-592
Mervin,1980,4888,Mervin,2009,4297,-591
Mohammad,1980,1862,Mohammad,2009,1272,-590
Claire,1980,732,Claire,2009,147,-585
Paige,1980,805,Paige,2009,220,-585
Aryeh,1980,3596,Aryeh,2009,3011,-585
Elise,1980,1030,Elise,2009,446,-584
Moshe,1980,1797,Moshe,2009,1213,-584
Ariel,1980,938,Ariel,2009,355,-583
Josie,1980,1193,Josie,2009,610,-583
Mauricio,1980,1377,Mauricio,2009,799,-578
Aubrey,1980,694,Aubrey,2009,117,-577
Cyrus,1980,1664,Cyrus,2009,1087,-577
Baila,1980,3279,Baila,2009,2704,-575
Desire,1980,3101,Desire,2009,2528,-573
Melina,1980,1458,Melina,2009,887,-571
Kiley,1980,1278,Kiley,2009,708,-570
Ada,1980,1631,Ada,2009,1064,-567
Donovan,1980,968,Donovan,2009,403,-565
Kiana,1980,1592,Kiana,2009,1029,-563
Libby,1980,1981,Libby,2009,1419,-562
Juancarlos,1980,3404,Juancarlos,2009,2842,-562
Elijah,1980,590,Elijah,2009,30,-560
Harley,1980,1117,Harley,2009,559,-558
Nathen,1980,2702,Nathen,2009,2146,-556
Brady,1980,745,Brady,2009,192,-553
Ari,1980,1549,Ari,2009,998,-551
Alexandre,1980,3530,Alexandre,2009,2980,-550
Dominick,1980,1028,Dominick,2009,479,-549
Sol,1980,3994,Sol,2009,3446,-548
Julieta,1980,2602,Julieta,2009,2057,-545
Isabel,1980,788,Isabel,2009,247,-541
Samira,1980,2447,Samira,2009,1906,-541
Trenton,1980,927,Trenton,2009,387,-540
Davin,1980,1869,Davin,2009,1329,-540
Brianna,1980,628,Brianna,2009,89,-539
Kamran,1980,5746,Kamran,2009,5207,-539
Kelsey,1980,985,Kelsey,2009,449,-536
Jewel,1980,2255,Jewel,2009,1720,-535
Elimelech,1980,5273,Elimelech,2009,4740,-533
Xiomara,1980,2125,Xiomara,2009,1594,-531
Amaury,1980,4167,Amaury,2009,3636,-531
Vivian,1980,891,Vivian,2009,361,-530
Grace,1980,595,Grace,2009,69,-526
Samir,1980,2128,Samir,2009,1602,-526
Tevita,1980,5499,Tevita,2009,4976,-523
Dylan,1980,560,Dylan,2009,38,-522
Shlomo,1980,2752,Shlomo,2009,2230,-522
Taylor,1980,583,Taylor,2009,63,-520
Gabrielle,1980,736,Gabrielle,2009,219,-517
Marianna,1980,2033,Marianna,2009,1521,-512
Ahron,1980,5261,Ahron,2009,4749,-512
Liana,1980,1608,Liana,2009,1097,-511
Tessa,1980,944,Tessa,2009,438,-506
Julian,1980,593,Julian,2009,88,-505
Dania,1980,2342,Dania,2009,1838,-504
Kendall,1980,766,Kendall,2009,263,-503
Issac,1980,1372,Issac,2009,870,-502
Clara,1980,920,Clara,2009,419,-501
Faigy,1980,3301,Faigy,2009,2800,-501
Haley,1980,775,Haley,2009,276,-499
Brandyn,1980,4550,Brandyn,2009,4051,-499
Ali,1980,1126,Ali,2009,628,-498
Noah,1980,508,Noah,2009,12,-496
Berenice,1980,2391,Berenice,2009,1898,-493
Joaquin,1980,1088,Joaquin,2009,597,-491
Ivy,1980,1120,Ivy,2009,633,-487
Hayley,1980,1288,Hayley,2009,801,-487
Gisel,1980,4004,Gisel,2009,3517,-487
Jake,1980,711,Jake,2009,225,-486
Ty,1980,907,Ty,2009,421,-486
Zev,1980,3300,Zev,2009,2816,-484
Ryann,1980,1957,Ryann,2009,1477,-480
Darwin,1980,2059,Darwin,2009,1579,-480
Lili,1980,4636,Lili,2009,4157,-479
Damian,1980,703,Damian,2009,226,-477
Ayana,1980,1900,Ayana,2009,1426,-474
Acacia,1980,4487,Acacia,2009,4013,-474
Keven,1980,3002,Keven,2009,2529,-473
Chaya,1980,1777,Chaya,2009,1305,-472
Amal,1980,4583,Amal,2009,4112,-471
Bryce,1980,661,Bryce,2009,191,-470
Jonny,1980,4716,Jonny,2009,4251,-465
Darrien,1980,4750,Darrien,2009,4286,-464
Kekoa,1980,4283,Kekoa,2009,3821,-462
Williams,1980,5314,Williams,2009,4852,-462
Janai,1980,4505,Janai,2009,4044,-461
Catalina,1980,1589,Catalina,2009,1130,-459
Meir,1980,3472,Meir,2009,3015,-457
Selene,1980,2598,Selene,2009,2142,-456
Aileen,1980,1337,Aileen,2009,884,-453
Caleb,1980,493,Caleb,2009,44,-449
Tianna,1980,1973,Tianna,2009,1525,-448
Shamar,1980,2799,Shamar,2009,2352,-447
Lucia,1980,1051,Lucia,2009,609,-442
Michaela,1980,1172,Michaela,2009,730,-442
Emanuel,1980,963,Emanuel,2009,523,-440
Austen,1980,3349,Austen,2009,2909,-440
Olivia,1980,450,Olivia,2009,11,-439
Muhammed,1980,4890,Muhammed,2009,4452,-438
Amelia,1980,585,Amelia,2009,150,-435
Leonel,1980,1432,Leonel,2009,999,-433
Leo,1980,822,Leo,2009,392,-430
Evelyn,1980,544,Evelyn,2009,116,-428
Jocelyn,1980,601,Jocelyn,2009,173,-428
Daisy,1980,765,Daisy,2009,340,-425
Viviana,1980,1258,Viviana,2009,833,-425
Raleigh,1980,3866,Raleigh,2009,3441,-425
Alena,1980,1736,Alena,2009,1313,-423
Irvin,1980,2129,Irvin,2009,1709,-420
Ruby,1980,663,Ruby,2009,244,-419
Lisbeth,1980,3384,Lisbeth,2009,2970,-414
Markus,1980,1764,Markus,2009,1352,-412
Milagros,1980,1843,Milagros,2009,1432,-411
Chaim,1980,2029,Chaim,2009,1620,-409
Samia,1980,3743,Samia,2009,3335,-408
Mckay,1980,4342,Mckay,2009,3935,-407
Quintin,1980,1943,Quintin,2009,1538,-405
Jasmin,1980,972,Jasmin,2009,570,-402
Bruno,1980,2241,Bruno,2009,1840,-401
Katia,1980,2961,Katia,2009,2564,-397
Iliana,1980,1757,Iliana,2009,1362,-395
Carmelo,1980,2152,Carmelo,2009,1757,-395
Vikram,1980,5785,Vikram,2009,5392,-393
Fabian,1980,952,Fabian,2009,565,-387
Micaela,1980,2343,Micaela,2009,1956,-387
Charlotte,1980,552,Charlotte,2009,168,-384
Gabriela,1980,695,Gabriela,2009,312,-383
Barrett,1980,1552,Barrett,2009,1170,-382
Faith,1980,567,Faith,2009,189,-378
Junior,1980,1906,Junior,2009,1528,-378
Angelina,1980,578,Angelina,2009,201,-377
Shelby,1980,739,Shelby,2009,362,-377
Alexandra,1980,545,Alexandra,2009,170,-375
Alaina,1980,890,Alaina,2009,515,-375
Perla,1980,1397,Perla,2009,1022,-375
Marko,1980,3703,Marko,2009,3329,-374
Josephine,1980,795,Josephine,2009,425,-370
Preston,1980,582,Preston,2009,215,-367
Briana,1980,704,Briana,2009,337,-367
Dominic,1980,487,Dominic,2009,124,-363
Blake,1980,497,Blake,2009,136,-361
Syed,1980,3042,Syed,2009,2681,-361
Solomon,1980,1327,Solomon,2009,968,-359
Serene,1980,4259,Serene,2009,3900,-359
Elliott,1980,1001,Elliott,2009,643,-358
Mercy,1980,2680,Mercy,2009,2322,-358
Alen,1980,5693,Alen,2009,5337,-356
Tyrell,1980,2083,Tyrell,2009,1731,-352
Abner,1980,2882,Abner,2009,2532,-350
Graham,1980,861,Graham,2009,512,-349
Mustafa,1980,2532,Mustafa,2009,2183,-349
Rhett,1980,1745,Rhett,2009,1397,-348
Nino,1980,5759,Nino,2009,5411,-348
Alyssa,1980,424,Alyssa,2009,77,-347
Josemaria,1980,5744,Josemaria,2009,5397,-347
Talia,1980,1062,Talia,2009,717,-345
Rayna,1980,1972,Rayna,2009,1627,-345
Johnmichael,1980,4994,Johnmichael,2009,4649,-345
Cameron,1980,411,Cameron,2009,68,-343
Maggie,1980,821,Maggie,2009,478,-343
Austin,1980,431,Austin,2009,91,-340
Aldo,1980,1522,Aldo,2009,1183,-339
Kristian,1980,1370,Kristian,2009,1034,-336
Georgia,1980,999,Georgia,2009,665,-334
Deonte,1980,3418,Deonte,2009,3085,-333
Levi,1980,470,Levi,2009,139,-331
Simon,1980,838,Simon,2009,507,-331
Dante,1980,911,Dante,2009,581,-330
Eva,1980,551,Eva,2009,223,-328
Rivka,1980,2132,Rivka,2009,1806,-326
Hannah,1980,410,Hannah,2009,85,-325
Alanna,1980,1224,Alanna,2009,903,-321
Valentin,1980,1860,Valentin,2009,1540,-320
Franco,1980,1966,Franco,2009,1650,-316
Everett,1980,964,Everett,2009,650,-314
Nora,1980,730,Nora,2009,417,-313
Aren,1980,5699,Aren,2009,5386,-313
Abigail,1980,337,Abigail,2009,25,-312
Yaakov,1980,2739,Yaakov,2009,2430,-309
Bracha,1980,3813,Bracha,2009,3504,-309
Andres,1980,625,Andres,2009,318,-307
Jefferson,1980,1550,Jefferson,2009,1243,-307
Alexis,1980,338,Alexis,2009,36,-302
Chelsey,1980,2237,Chelsey,2009,1936,-301
Priya,1980,2842,Priya,2009,2541,-301
Francesca,1980,1208,Francesca,2009,909,-299
Alana,1980,675,Alana,2009,377,-298
Helena,1980,1336,Helena,2009,1043,-293
Lela,1980,2841,Lela,2009,2548,-293
Roshan,1980,4893,Roshan,2009,4600,-293
Eve,1980,1375,Eve,2009,1083,-292
Donavan,1980,2538,Donavan,2009,2249,-289
Shae,1980,3600,Shae,2009,3312,-288
Jamison,1980,1408,Jamison,2009,1121,-287
Yitzchok,1980,2753,Yitzchok,2009,2466,-287
Davon,1980,1905,Davon,2009,1619,-286
Soraya,1980,2679,Soraya,2009,2395,-284
Jasmine,1980,425,Jasmine,2009,144,-281
Evan,1980,329,Evan,2009,50,-279
Dane,1980,1034,Dane,2009,756,-278
Lydia,1980,539,Lydia,2009,262,-277
Audrey,1980,416,Audrey,2009,140,-276
Chelsea,1980,756,Chelsea,2009,480,-276
Vanesa,1980,2629,Vanesa,2009,2354,-275
Adrina,1980,4577,Adrina,2009,4305,-272
Jack,1980,331,Jack,2009,60,-271
Ivan,1980,520,Ivan,2009,249,-271
Anya,1980,989,Anya,2009,718,-271
Ismail,1980,3447,Ismail,2009,3178,-269
Kristiana,1980,4509,Kristiana,2009,4241,-268
Conor,1980,1381,Conor,2009,1114,-267
Chava,1980,3280,Chava,2009,3014,-266
Sheridan,1980,4455,Sheridan,2009,4189,-266
Moises,1980,1063,Moises,2009,798,-265
Nicolas,1980,554,Nicolas,2009,290,-264
Abraham,1980,592,Abraham,2009,332,-260
Israel,1980,656,Israel,2009,396,-260
Charlie,1980,666,Charlie,2009,409,-257
Micah,1980,439,Micah,2009,184,-255
Brenna,1980,1103,Brenna,2009,850,-253
Rami,1980,4060,Rami,2009,3808,-252
Isaac,1980,306,Isaac,2009,56,-250
Elena,1980,668,Elena,2009,418,-250
Eduardo,1980,476,Eduardo,2009,227,-249
Olivier,1980,4059,Olivier,2009,3810,-249
Arwen,1980,4489,Arwen,2009,4242,-247
Ahmad,1980,1229,Ahmad,2009,984,-245
Nadia,1980,750,Nadia,2009,506,-244
Brendon,1980,1413,Brendon,2009,1171,-242
Alejandra,1980,797,Alejandra,2009,556,-241
Jordan,1980,288,Jordan,2009,48,-240
Karmen,1980,2304,Karmen,2009,2065,-239
Jonas,1980,996,Jonas,2009,759,-237
Raizy,1980,3175,Raizy,2009,2938,-237
Eleni,1980,2928,Eleni,2009,2692,-236
Jeremias,1980,3001,Jeremias,2009,2768,-233
Samson,1980,2151,Samson,2009,1919,-232
Adele,1980,2250,Adele,2009,2018,-232
Fredy,1980,3026,Fredy,2009,2794,-232
Jules,1980,3802,Jules,2009,3571,-231
Melani,1980,2895,Melani,2009,2667,-228
Daphne,1980,1129,Daphne,2009,904,-225
Raphael,1980,1539,Raphael,2009,1315,-224
Colin,1980,422,Colin,2009,199,-223
Malka,1980,2339,Malka,2009,2119,-220
Lizeth,1980,1923,Lizeth,2009,1704,-219
Jaron,1980,2313,Jaron,2009,2094,-219
Danya,1980,3662,Danya,2009,3443,-219
Benton,1980,4088,Benton,2009,3872,-216
Allyson,1980,726,Allyson,2009,513,-213
Selena,1980,852,Selena,2009,639,-213
Spencer,1980,619,Spencer,2009,407,-212
Dorian,1980,1285,Dorian,2009,1074,-211
Genevieve,1980,783,Genevieve,2009,576,-207
Saul,1980,931,Saul,2009,724,-207
Marlen,1980,2547,Marlen,2009,2341,-206
Marcelo,1980,2046,Marcelo,2009,1842,-204
Krisha,1980,5363,Krisha,2009,5159,-204
Christian,1980,234,Christian,2009,31,-203
Cecelia,1980,1570,Cecelia,2009,1367,-203
Adia,1980,4913,Adia,2009,4711,-202
Prince,1980,1672,Prince,2009,1471,-201
Alex,1980,326,Alex,2009,126,-200
Tyler,1980,232,Tyler,2009,39,-193
Cesar,1980,564,Cesar,2009,372,-192
Bianca,1980,678,Bianca,2009,487,-191
Jenna,1980,465,Jenna,2009,275,-190
Athena,1980,1021,Athena,2009,831,-190
Adelina,1980,2293,Adelina,2009,2103,-190
Morgan,1980,317,Morgan,2009,132,-185
Caroline,1980,386,Caroline,2009,202,-184
Simone,1980,1321,Simone,2009,1137,-184
Dalila,1980,2319,Dalila,2009,2136,-183
Hank,1980,2619,Hank,2009,2437,-182
Nivea,1980,5002,Nivea,2009,4820,-182
Devin,1980,390,Devin,2009,210,-180
Grant,1980,448,Grant,2009,269,-179
Alexander,1980,184,Alexander,2009,6,-178
Adriana,1980,459,Adriana,2009,281,-178
Rhea,1980,2121,Rhea,2009,1944,-177
Cordell,1980,2410,Cordell,2009,2234,-176
Braulio,1980,2995,Braulio,2009,2821,-174
Raina,1980,1727,Raina,2009,1557,-170
Iva,1980,5079,Iva,2009,4909,-170
Ismael,1980,892,Ismael,2009,723,-169
Esteban,1980,957,Esteban,2009,788,-169
Marbella,1980,4642,Marbella,2009,4474,-168
Alejandro,1980,385,Alejandro,2009,218,-167
Henry,1980,273,Henry,2009,108,-165
Jabari,1980,2012,Jabari,2009,1847,-165
Sidney,1980,967,Sidney,2009,804,-163
Kourtney,1980,1710,Kourtney,2009,1548,-162
Britany,1980,3479,Britany,2009,3317,-162
Angel,1980,201,Angel,2009,40,-161
Sima,1980,4114,Sima,2009,3953,-161
Syeda,1980,5049,Syeda,2009,4888,-161
Naomi,1980,403,Naomi,2009,243,-160
Christiana,1980,2054,Christiana,2009,1895,-159
Dalia,1980,1856,Dalia,2009,1698,-158
Kimberlyn,1980,4631,Kimberlyn,2009,4473,-158
Esmeralda,1980,755,Esmeralda,2009,600,-155
Erick,1980,506,Erick,2009,352,-154
Iris,1980,779,Iris,2009,625,-154
Gustavo,1980,901,Gustavo,2009,749,-152
Greta,1980,1431,Greta,2009,1279,-152
Cristal,1980,1729,Cristal,2009,1577,-152
Edgar,1980,525,Edgar,2009,376,-149
Autumn,1980,343,Autumn,2009,196,-147
Carly,1980,599,Carly,2009,453,-146
Gabriel,1980,174,Gabriel,2009,29,-145
Adrian,1980,227,Adrian,2009,83,-144
Coby,1980,2430,Coby,2009,2286,-144
Sameer,1980,3769,Sameer,2009,3625,-144
Lucas,1980,197,Lucas,2009,55,-142
Abel,1980,815,Abel,2009,675,-140
Domonic,1980,4706,Domonic,2009,4566,-140
Oscar,1980,371,Oscar,2009,234,-137
Stephany,1980,1892,Stephany,2009,1756,-136
Idris,1980,3467,Idris,2009,3332,-135
Venice,1980,5053,Venice,2009,4920,-133
Luke,1980,196,Luke,2009,65,-131
Elan,1980,3976,Elan,2009,3845,-131
Rosy,1980,5646,Rosy,2009,5515,-131
Drew,1980,624,Drew,2009,495,-129
Marcos,1980,679,Marcos,2009,551,-128
Cecilia,1980,667,Cecilia,2009,540,-127
Tobias,1980,1204,Tobias,2009,1078,-126
Sasha,1980,660,Sasha,2009,535,-125
Caitlin,1980,669,Caitlin,2009,546,-123
Deandre,1980,1125,Deandre,2009,1002,-123
Leia,1980,1650,Leia,2009,1527,-123
Katerina,1980,2816,Katerina,2009,2693,-123
Chelsie,1980,2780,Chelsie,2009,2658,-122
Hugo,1980,958,Hugo,2009,841,-117
Vincenzo,1980,2115,Vincenzo,2009,1998,-117
Tiara,1980,1902,Tiara,2009,1787,-115
Aline,1980,4582,Aline,2009,4468,-114
Hope,1980,587,Hope,2009,474,-113
Julius,1980,752,Julius,2009,640,-112
Addie,1980,2072,Addie,2009,1960,-112
Charisma,1980,4075,Charisma,2009,3963,-112
Reyna,1980,1421,Reyna,2009,1310,-111
Danae,1980,2710,Danae,2009,2599,-111
Victoria,1980,209,Victoria,2009,101,-108
Rosalie,1980,1620,Rosalie,2009,1512,-108
Jesus,1980,225,Jesus,2009,122,-103
Ian,1980,211,Ian,2009,111,-100
Darius,1980,776,Darius,2009,677,-99
Safiya,1980,4112,Safiya,2009,4014,-98
Miguel,1980,267,Miguel,2009,171,-96
Trent,1980,701,Trent,2009,606,-95
Shayla,1980,857,Shayla,2009,762,-95
Angelo,1980,681,Angelo,2009,587,-94
Carolina,1980,844,Carolina,2009,751,-93
Janae,1980,1445,Janae,2009,1354,-91
Ashely,1980,4924,Ashely,2009,4834,-90
India,1980,1594,India,2009,1506,-88
Kenia,1980,2345,Kenia,2009,2257,-88
Shelbie,1980,4540,Shelbie,2009,4453,-87
Kalvin,1980,2951,Kalvin,2009,2870,-81
Alice,1980,614,Alice,2009,534,-80
Pablo,1980,782,Pablo,2009,702,-80
Osvaldo,1980,1542,Osvaldo,2009,1462,-80
Yara,1980,2266,Yara,2009,2186,-80
Hyrum,1980,3008,Hyrum,2009,2928,-80
Andy,1980,498,Andy,2009,420,-78
Bilal,1980,2530,Bilal,2009,2452,-78
Sarina,1980,2230,Sarina,2009,2153,-77
Jacob,1980,78,Jacob,2009,2,-76
Luis,1980,181,Luis,2009,105,-76
Natalie,1980,133,Natalie,2009,58,-75
Camille,1980,650,Camille,2009,575,-75
Fernando,1980,404,Fernando,2009,330,-74
Sergio,1980,505,Sergio,2009,431,-74
Omar,1980,357,Omar,2009,284,-73
Zachary,1980,146,Zachary,2009,74,-72
Felix,1980,763,Felix,2009,692,-71
Samantha,1980,123,Samantha,2009,53,-70
Julianne,1980,1233,Julianne,2009,1163,-70
Leah,1980,168,Leah,2009,99,-69
Samuel,1980,100,Samuel,2009,32,-68
Taryn,1980,1127,Taryn,2009,1059,-68
Tariq,1980,3180,Tariq,2009,3114,-66
Karina,1980,662,Karina,2009,598,-64
Estella,1980,2119,Estella,2009,2056,-63
Yechiel,1980,3826,Yechiel,2009,3765,-61
Jeremiah,1980,153,Jeremiah,2009,94,-59
Julia,1980,199,Julia,2009,142,-57
Nathaniel,1980,175,Nathaniel,2009,119,-56
Brendan,1980,456,Brendan,2009,400,-56
Tyson,1980,510,Tyson,2009,454,-56
Brooks,1980,1055,Brooks,2009,1000,-55
Kenyon,1980,2058,Kenyon,2009,2003,-55
Quentin,1980,818,Quentin,2009,764,-54
Emily,1980,73,Emily,2009,20,-53
Trevor,1980,325,Trevor,2009,272,-53
Shaindy,1980,3469,Shaindy,2009,3417,-52
Quinton,1980,1122,Quinton,2009,1072,-50
Deshawn,1980,1497,Deshawn,2009,1447,-50
Garrett,1980,387,Garrett,2009,339,-48
Chana,1980,1454,Chana,2009,1406,-48
Vance,1980,1678,Vance,2009,1630,-48
Ellis,1980,1407,Ellis,2009,1360,-47
Keon,1980,1933,Keon,2009,1886,-47
Molly,1980,257,Molly,2009,211,-46
Xochitl,1980,2413,Xochitl,2009,2367,-46
Javier,1980,389,Javier,2009,347,-42
Kenji,1980,2656,Kenji,2009,2614,-42
Aracely,1980,1558,Aracely,2009,1517,-41
Amalia,1980,1924,Amalia,2009,1884,-40
Nechama,1980,2749,Nechama,2009,2709,-40
Cody,1980,284,Cody,2009,245,-39
Selma,1980,4213,Selma,2009,4174,-39
Darrius,1980,2412,Darrius,2009,2376,-36
Devora,1980,3814,Devora,2009,3778,-36
Edwin,1980,392,Edwin,2009,357,-35
Shanice,1980,5241,Shanice,2009,5206,-35
Damien,1980,380,Damien,2009,348,-32
Carlos,1980,154,Carlos,2009,123,-31
Brock,1980,636,Brock,2009,605,-31
Kate,1980,383,Kate,2009,354,-29
Nathan,1980,62,Nathan,2009,34,-28
Noelia,1980,2111,Noelia,2009,2083,-28
Allison,1980,126,Allison,2009,100,-26
Tori,1980,1050,Tori,2009,1024,-26
Marco,1980,488,Marco,2009,463,-25
Benjamin,1980,52,Benjamin,2009,28,-24
Lorenzo,1980,707,Lorenzo,2009,683,-24
Elia,1980,2441,Elia,2009,2417,-24
Noelani,1980,3612,Noelani,2009,3588,-24
Anna,1980,121,Anna,2009,98,-23
Anthony,1980,37,Anthony,2009,15,-22
Yehoshua,1980,3638,Yehoshua,2009,3618,-20
Jose,1980,80,Jose,2009,61,-19
Esther,1980,558,Esther,2009,542,-16
Eliezer,1980,2026,Eliezer,2009,2010,-16
Amar,1980,3004,Amar,2009,2988,-16
Elisheva,1980,3895,Elisheva,2009,3879,-16
Tye,1980,2828,Tye,2009,2813,-15
Vincent,1980,226,Vincent,2009,212,-14
Brea,1980,2404,Brea,2009,2391,-13
William,1980,18,William,2009,7,-11
Noelle,1980,841,Noelle,2009,830,-11
Dov,1980,3137,Dov,2009,3126,-11
Akiva,1980,3471,Akiva,2009,3460,-11
Isreal,1980,3518,Isreal,2009,3507,-11
Victor,1980,217,Victor,2009,208,-9
Dallas,1980,610,Dallas,2009,602,-8
Juan,1980,109,Juan,2009,102,-7
Shea,1980,1461,Shea,2009,1454,-7
Daniel,1980,15,Daniel,2009,10,-5
Mercedes,1980,1191,Mercedes,2009,1186,-5
Andrew,1980,27,Andrew,2009,24,-3
Zachariah,1980,896,Zachariah,2009,893,-3
Dexter,1980,1149,Dexter,2009,1146,-3
Britney,1980,1385,Britney,2009,1382,-3
Ashley,1980,83,Ashley,2009,81,-2
Gerardo,1980,665,Gerardo,2009,663,-2
Alysa,1980,3192,Alysa,2009,3190,-2
Nathanael,1980,975,Nathanael,2009,974,-1
Joshua,1980,8,Joshua,2009,9,1
Brandon,1980,50,Brandon,2009,52,2
Jorge,1980,283,Jorge,2009,286,3
Michael,1980,1,Michael,2009,5,4
Lena,1980,794,Lena,2009,800,6
Wilson,1980,1132,Wilson,2009,1138,6
Ryan,1980,20,Ryan,2009,27,7
Joseph,1980,14,Joseph,2009,23,9
Matthew,1980,7,Matthew,2009,17,10
Christopher,1980,3,Christopher,2009,14,11
Jonathan,1980,31,Jonathan,2009,42,11
Ana,1980,378,Ana,2009,389,11
David,1980,5,David,2009,19,14
Domenic,1980,2332,Domenic,2009,2346,14
Paolo,1980,3033,Paolo,2009,3047,14
Elizabeth,1980,28,Elizabeth,2009,43,15
Jillian,1980,330,Jillian,2009,345,15
Jayson,1980,685,Jayson,2009,700,15
Hassan,1980,1671,Hassan,2009,1687,16
Fabiana,1980,4824,Fabiana,2009,4840,16
Guadalupe,1980,532,Guadalupe,2009,549,17
Emilie,1980,1328,Emilie,2009,1347,19
James,1980,6,James,2009,26,20
Aaron,1980,55,Aaron,2009,76,21
Abby,1980,509,Abby,2009,530,21
Francisco,1980,313,Francisco,2009,335,22
Hector,1980,359,Hector,2009,381,22
Johnathan,1980,363,Johnathan,2009,385,22
June,1980,1238,June,2009,1260,22
Vera,1980,1610,Vera,2009,1632,22
Nicholas,1980,22,Nicholas,2009,45,23
Marielle,1980,3687,Marielle,2009,3710,23
John,1980,10,John,2009,35,25
Brooke,1980,122,Brooke,2009,148,26
Kevin,1980,34,Kevin,2009,62,28
Marissa,1980,365,Marissa,2009,394,29
Desmond,1980,751,Desmond,2009,781,30
Antonio,1980,152,Antonio,2009,183,31
Alan,1980,229,Alan,2009,261,32
Angeline,1980,1512,Angeline,2009,1544,32
Julio,1980,579,Julio,2009,612,33
Miriam,1980,577,Miriam,2009,611,34
Will,1980,1161,Will,2009,1196,35
Elsa,1980,1231,Elsa,2009,1266,35
Flynn,1980,5724,Flynn,2009,5760,36
Sam,1980,942,Sam,2009,979,37
Franchesca,1980,3444,Franchesca,2009,3483,39
Lauren,1980,88,Lauren,2009,129,41
Keenan,1980,1562,Keenan,2009,1603,41
Winter,1980,1806,Winter,2009,1849,43
Keely,1980,1604,Keely,2009,1648,44
Jerimiah,1980,2153,Jerimiah,2009,2197,44
Lana,1980,817,Lana,2009,862,45
Thomas,1980,38,Thomas,2009,84,46
Enrique,1980,576,Enrique,2009,622,46
Antony,1980,2149,Antony,2009,2195,46
Justin,1980,17,Justin,2009,64,47
Charles,1980,46,Charles,2009,93,47
Nelly,1980,2107,Nelly,2009,2155,48
Kahlil,1980,3252,Kahlil,2009,3300,48
Noe,1980,1076,Noe,2009,1125,49
Keyanna,1980,4789,Keyanna,2009,4839,50
Dean,1980,566,Dean,2009,617,51
Yusef,1980,3705,Yusef,2009,3756,51
Seth,1980,200,Seth,2009,253,53
Calvin,1980,382,Calvin,2009,436,54
Sholom,1980,4320,Sholom,2009,4378,58
Bryan,1980,87,Bryan,2009,146,59
Zachery,1980,1289,Zachery,2009,1348,59
Cortez,1980,1837,Cortez,2009,1896,59
Summer,1980,314,Summer,2009,375,61
Ricardo,1980,248,Ricardo,2009,310,62
Quran,1980,4807,Quran,2009,4869,62
Sarah,1980,19,Sarah,2009,82,63
Moses,1980,986,Moses,2009,1050,64
Bryn,1980,2641,Bryn,2009,2705,64
Pedro,1980,467,Pedro,2009,532,65
Mariela,1980,1666,Mariela,2009,1732,66
Kyle,1980,102,Kyle,2009,169,67
Mireya,1980,1718,Mireya,2009,1785,67
Robert,1980,11,Robert,2009,80,69
Vanessa,1980,138,Vanessa,2009,209,71
Joel,1980,135,Joel,2009,207,72
Devon,1980,453,Devon,2009,525,72
Kamilah,1980,2174,Kamilah,2009,2246,72
Manuel,1980,291,Manuel,2009,364,73
Rafael,1980,430,Rafael,2009,505,75
Katherine,1980,82,Katherine,2009,158,76
Sean,1980,86,Sean,2009,162,76
Marcus,1980,144,Marcus,2009,221,77
Devorah,1980,3047,Devorah,2009,3125,78
Batsheva,1980,4294,Batsheva,2009,4375,81
Rosalee,1980,4661,Rosalee,2009,4742,81
Adam,1980,32,Adam,2009,114,82
Yasmeen,1980,3020,Yasmeen,2009,3105,85
Monroe,1980,4430,Monroe,2009,4515,85
Abbie,1980,1291,Abbie,2009,1377,86
Melanie,1980,127,Melanie,2009,214,87
Maria,1980,84,Maria,2009,172,88
Waylon,1980,893,Waylon,2009,983,90
Jason,1980,4,Jason,2009,96,92
Melody,1980,384,Melody,2009,476,92
Leeanna,1980,3944,Leeanna,2009,4036,92
Malcolm,1980,1160,Malcolm,2009,1254,94
Anette,1980,4228,Anette,2009,4323,95
Brandt,1980,2881,Brandt,2009,2977,96
Serena,1980,674,Serena,2009,771,97
Raylene,1980,3929,Raylene,2009,4027,98
Lilia,1980,1546,Lilia,2009,1647,101
Alyson,1980,803,Alyson,2009,905,102
Karim,1980,2363,Karim,2009,2468,105
Hindy,1980,4108,Hindy,2009,4215,107
Rory,1980,974,Rory,2009,1082,108
Karla,1980,483,Karla,2009,592,109
Andrea,1980,66,Andrea,2009,176,110
Jesse,1980,77,Jesse,2009,193,116
Yahaira,1980,2281,Yahaira,2009,2402,121
Reina,1980,1600,Reina,2009,1722,122
Theodore,1980,420,Theodore,2009,544,124
Deangelo,1980,1649,Deangelo,2009,1773,124
Dixie,1980,1531,Dixie,2009,1659,128
Eric,1980,21,Eric,2009,153,132
Wesley,1980,190,Wesley,2009,322,132
Diana,1980,235,Diana,2009,367,132
Karissa,1980,1393,Karissa,2009,1526,133
Kimberly,1980,33,Kimberly,2009,167,134
Leona,1980,1633,Leona,2009,1767,134
Brian,1980,16,Brian,2009,152,136
Marina,1980,991,Marina,2009,1129,138
Valerie,1980,169,Valerie,2009,308,139
Clayton,1980,396,Clayton,2009,536,140
Carmine,1980,2291,Carmine,2009,2432,141
Steven,1980,43,Steven,2009,185,142
Conrad,1980,1468,Conrad,2009,1612,144
Magaly,1980,2974,Magaly,2009,3118,144
Rachel,1980,59,Rachel,2009,205,146
Miranda,1980,245,Miranda,2009,391,146
Damion,1980,1248,Damion,2009,1394,146
Lina,1980,1547,Lina,2009,1693,146
Queen,1980,4843,Queen,2009,4990,147
Neftali,1980,3713,Neftali,2009,3862,149
Andre,1980,272,Andre,2009,424,152
Edward,1980,93,Edward,2009,246,153
Armando,1980,455,Armando,2009,608,153
Dominique,1980,929,Dominique,2009,1086,157
Aron,1980,1198,Aron,2009,1355,157
Kainoa,1980,3583,Kainoa,2009,3742,159
Gentry,1980,4142,Gentry,2009,4301,159
Timothy,1980,29,Timothy,2009,190,161
Patrick,1980,67,Patrick,2009,229,162
Mario,1980,206,Mario,2009,368,162
Richard,1980,39,Richard,2009,203,164
Bryant,1980,687,Bryant,2009,851,164
Megan,1980,72,Megan,2009,239,167
Mollie,1980,1119,Mollie,2009,1286,167
Mara,1980,1209,Mara,2009,1379,170
Mary,1980,60,Mary,2009,231,171
Jane,1980,581,Jane,2009,753,172
Celeste,1980,718,Celeste,2009,890,172
Geraldine,1980,1989,Geraldine,2009,2161,172
Edson,1980,4269,Edson,2009,4441,172
Vince,1980,2696,Vince,2009,2869,173
Jessica,1980,12,Jessica,2009,187,175
Noel,1980,713,Noel,2009,889,176
Guillermo,1980,889,Guillermo,2009,1065,176
Andreas,1980,2218,Andreas,2009,2394,176
Josemanuel,1980,4717,Josemanuel,2009,4894,177
Sara,1980,63,Sara,2009,242,179
Blaine,1980,1174,Blaine,2009,1356,182
Tiana,1980,921,Tiana,2009,1104,183
Margaret,1980,212,Margaret,2009,398,186
Kendra,1980,301,Kendra,2009,488,187
George,1980,113,George,2009,301,188
Roberto,1980,294,Roberto,2009,482,188
Angie,1980,471,Angie,2009,660,189
Shane,1980,139,Shane,2009,329,190
Broderick,1980,1598,Broderick,2009,1788,190
Martin,1980,256,Martin,2009,448,192
Van,1980,1482,Van,2009,1674,192
Vaughn,1980,1551,Vaughn,2009,1743,192
Gittel,1980,4107,Gittel,2009,4299,192
Amethyst,1980,5365,Amethyst,2009,5559,194
Duke,1980,4052,Duke,2009,4247,195
Jacqueline,1980,162,Jacqueline,2009,359,197
Regan,1980,1137,Regan,2009,1335,198
Arturo,1980,589,Arturo,2009,789,200
Nigel,1980,1599,Nigel,2009,1801,202
Rochel,1980,2850,Rochel,2009,3053,203
Tyree,1980,1554,Tyree,2009,1758,204
Michelle,1980,30,Michelle,2009,237,207
Kenneth,1980,70,Kenneth,2009,278,208
Winston,1980,1508,Winston,2009,1717,209
Oswaldo,1980,2178,Oswaldo,2009,2387,209
Hattie,1980,2983,Hattie,2009,3192,209
Eddy,1980,2057,Eddy,2009,2267,210
Damaris,1980,1414,Damaris,2009,1626,212
Ruben,1980,349,Ruben,2009,562,213
Noemi,1980,1054,Noemi,2009,1268,214
Stephanie,1980,36,Stephanie,2009,254,218
Katie,1980,98,Katie,2009,317,219
Derek,1980,90,Derek,2009,311,221
Deonna,1980,3915,Deonna,2009,4137,222
Catherine,1980,156,Catherine,2009,379,223
Salvador,1980,654,Salvador,2009,877,223
Jeremy,1980,24,Jeremy,2009,252,228
Mark,1980,51,Mark,2009,279,228
Sabrina,1980,222,Sabrina,2009,455,233
Brice,1980,1405,Brice,2009,1638,233
Leslie,1980,116,Leslie,2009,350,234
Simeon,1980,2036,Simeon,2009,2270,234
Orlando,1980,611,Orlando,2009,846,235
Paul,1980,58,Paul,2009,294,236
Cecily,1980,2967,Cecily,2009,3204,237
Lucky,1980,4566,Lucky,2009,4803,237
Cedar,1980,5541,Cedar,2009,5778,237
Rose,1980,447,Rose,2009,685,238
Princess,1980,1395,Princess,2009,1633,238
Cristobal,1980,1985,Cristobal,2009,2223,238
Raul,1980,399,Raul,2009,638,239
Nicole,1980,25,Nicole,2009,265,240
Marisol,1980,652,Marisol,2009,892,240
Rebeca,1980,1452,Rebeca,2009,1692,240
Esperanza,1980,1520,Esperanza,2009,1760,240
Kara,1980,244,Kara,2009,485,241
Angelica,1980,354,Angelica,2009,595,241
Helen,1980,514,Helen,2009,755,241
Autum,1980,4586,Autum,2009,4827,241
Precious,1980,1173,Precious,2009,1415,242
Troy,1980,215,Troy,2009,459,244
Jennifer,1980,2,Jennifer,2009,248,246
Tomas,1980,953,Tomas,2009,1199,246
Rebecca,1980,45,Rebecca,2009,293,248
Peter,1980,101,Peter,2009,349,248
Carmen,1980,345,Carmen,2009,593,248
Chris,1980,481,Chris,2009,729,248
Annie,1980,490,Annie,2009,740,250
Ammon,1980,3009,Ammon,2009,3263,254
Celia,1980,1153,Celia,2009,1409,256
Raven,1980,886,Raven,2009,1143,257
Pearl,1980,1556,Pearl,2009,1814,258
Rayleen,1980,4658,Rayleen,2009,4916,258
Travis,1980,65,Travis,2009,325,260
Eben,1980,3591,Eben,2009,3851,260
Amy,1980,26,Amy,2009,291,265
Vicente,1980,1176,Vicente,2009,1442,266
Alison,1980,205,Alison,2009,473,268
Bradley,1980,91,Bradley,2009,360,269
Quincy,1980,757,Quincy,2009,1026,269
Johnny,1980,233,Johnny,2009,509,276
Khalid,1980,2377,Khalid,2009,2654,277
Alberto,1980,524,Alberto,2009,803,279
Angela,1980,35,Angela,2009,316,281
Jared,1980,117,Jared,2009,399,282
Joanna,1980,319,Joanna,2009,601,282
Rashad,1980,1006,Rashad,2009,1288,282
Nickolas,1980,637,Nickolas,2009,921,284
Eryn,1980,2681,Eryn,2009,2965,284
Leanna,1980,1065,Leanna,2009,1350,285
Ruth,1980,408,Ruth,2009,694,286
Raymond,1980,134,Raymond,2009,422,288
Marshall,1980,555,Marshall,2009,845,290
Carina,1980,1296,Carina,2009,1586,290
Analisa,1980,2811,Analisa,2009,3101,290
Hakeem,1980,3812,Hakeem,2009,4102,290
Nina,1980,292,Nina,2009,583,291
Maritza,1980,961,Maritza,2009,1253,292
Clark,1980,1212,Clark,2009,1505,293
Melissa,1980,13,Melissa,2009,307,294
Clarissa,1980,867,Clarissa,2009,1161,294
Magdalena,1980,1455,Magdalena,2009,1750,295
Joseluis,1980,2694,Joseluis,2009,2990,296
Danielle,1980,75,Danielle,2009,373,298
Marquis,1980,1004,Marquis,2009,1302,298
Gwendolyn,1980,789,Gwendolyn,2009,1090,301
Stephen,1980,69,Stephen,2009,371,302
Kendrick,1980,807,Kendrick,2009,1110,303
Ashlee,1980,866,Ashlee,2009,1169,303
Agustin,1980,1440,Agustin,2009,1744,304
Harlan,1980,2454,Harlan,2009,2760,306
Ernesto,1980,670,Ernesto,2009,977,307
Lacey,1980,521,Lacey,2009,832,311
Gillian,1980,1505,Gillian,2009,1816,311
Mariano,1980,2163,Mariano,2009,2474,311
Shamus,1980,5114,Shamus,2009,5425,311
Shawn,1980,81,Shawn,2009,393,312
Violeta,1980,1687,Violeta,2009,1999,312
Maren,1980,1618,Maren,2009,1933,315
Alvaro,1980,1346,Alvaro,2009,1662,316
Erik,1980,124,Erik,2009,441,317
Alfredo,1980,574,Alfredo,2009,891,317
Lyndon,1980,3257,Lyndon,2009,3576,319
Dontae,1980,2166,Dontae,2009,2490,324
Estevan,1980,1911,Estevan,2009,2236,325
Emil,1980,2329,Emil,2009,2655,326
Yessica,1980,2958,Yessica,2009,3288,330
Jacobo,1980,3127,Jacobo,2009,3457,330
Kelvin,1980,676,Kelvin,2009,1009,333
Alicia,1980,106,Alicia,2009,440,334
Felipe,1980,875,Felipe,2009,1212,337
Amber,1980,57,Amber,2009,395,338
Byron,1980,480,Byron,2009,818,338
Yesenia,1980,771,Yesenia,2009,1109,338
Mohamad,1980,3532,Mohamad,2009,3871,339
Kathryn,1980,108,Kathryn,2009,450,342
Allegra,1980,3106,Allegra,2009,3449,343
Gitty,1980,2595,Gitty,2009,2939,344
Johnson,1980,3089,Johnson,2009,3433,344
Benedict,1980,3574,Benedict,2009,3920,346
Elie,1980,4707,Elie,2009,5055,348
Erin,1980,53,Erin,2009,404,351
Naftali,1980,3306,Naftali,2009,3657,351
Anela,1980,4145,Anela,2009,4498,353
Amanda,1980,9,Amanda,2009,363,354
Luisa,1980,1688,Luisa,2009,2042,354
Blima,1980,4106,Blima,2009,4460,354
Chanel,1980,1101,Chanel,2009,1456,355
Karen,1980,119,Karen,2009,477,358
Roxana,1980,1680,Roxana,2009,2038,358
Patricio,1980,2504,Patricio,2009,2862,358
Bo,1980,1251,Bo,2009,1610,359
Asha,1980,1992,Asha,2009,2351,359
Johana,1980,1619,Johana,2009,1980,361
Alissa,1980,501,Alissa,2009,863,362
Britton,1980,2531,Britton,2009,2893,362
Kentrell,1980,2845,Kentrell,2009,3208,363
Dario,1980,1588,Dario,2009,1952,364
Jeffrey,1980,40,Jeffrey,2009,405,365
Branden,1980,898,Branden,2009,1265,367
Alonzo,1980,922,Alonzo,2009,1289,367
Johanna,1980,542,Johanna,2009,911,369
Ragan,1980,5512,Ragan,2009,5881,369
Ingrid,1980,1118,Ingrid,2009,1488,370
Marilyn,1980,725,Marilyn,2009,1096,371
Allen,1980,258,Allen,2009,630,372
Lupita,1980,2227,Lupita,2009,2605,378
Deshaun,1980,2141,Deshaun,2009,2521,380
Yessenia,1980,2443,Yessenia,2009,2823,380
Ulysses,1980,1836,Ulysses,2009,2219,383
Cassandra,1980,268,Cassandra,2009,655,387
Anson,1980,2143,Anson,2009,2530,387
Mitchell,1980,347,Mitchell,2009,736,389
Warren,1980,569,Warren,2009,959,390
Beatrice,1980,1107,Beatrice,2009,1498,391
Casey,1980,111,Casey,2009,504,393
Danny,1980,253,Danny,2009,647,394
Rebekah,1980,318,Rebekah,2009,713,395
Mathew,1980,381,Mathew,2009,776,395
Mauro,1980,2463,Mauro,2009,2860,397
Beau,1980,419,Beau,2009,817,398
Elisabeth,1980,602,Elisabeth,2009,1001,399
Ashanti,1980,1350,Ashanti,2009,1752,402
Gema,1980,3924,Gema,2009,4327,403
Tierra,1980,3495,Tierra,2009,3903,408
Kenya,1980,723,Kenya,2009,1132,409
Kenton,1980,2062,Kenton,2009,2471,409
Gregory,1980,71,Gregory,2009,481,410
Louis,1980,309,Louis,2009,720,411
Leon,1980,531,Leon,2009,943,412
Darleen,1980,5557,Darleen,2009,5970,413
Allan,1980,749,Allan,2009,1166,417
Shira,1980,1903,Shira,2009,2320,417
Blythe,1980,3553,Blythe,2009,3971,418
Frank,1980,165,Frank,2009,584,419
Freddy,1980,1253,Freddy,2009,1673,420
Janelle,1980,367,Janelle,2009,790,423
Ramon,1980,443,Ramon,2009,866,423
Christina,1980,42,Christina,2009,467,425
Johnathon,1980,900,Johnathon,2009,1325,425
Laura,1980,56,Laura,2009,483,427
Marvin,1980,413,Marvin,2009,840,427
Danilo,1980,3417,Danilo,2009,3846,429
Heidi,1980,159,Heidi,2009,589,430
Bethany,1980,241,Bethany,2009,671,430
Veronica,1980,140,Veronica,2009,574,434
Adela,1980,2172,Adela,2009,2606,434
Elmer,1980,1525,Elmer,2009,1962,437
Mabel,1980,2341,Mabel,2009,2779,438
Farrah,1980,1564,Farrah,2009,2005,441
German,1980,1658,German,2009,2099,441
Rivkah,1980,4111,Rivkah,2009,4553,442
Derrick,1980,151,Derrick,2009,596,445
Yadira,1980,1086,Yadira,2009,1532,446
Marcel,1980,1492,Marcel,2009,1938,446
Araceli,1980,928,Araceli,2009,1376,448
Nelson,1980,645,Nelson,2009,1094,449
Aundre,1980,4956,Aundre,2009,5406,450
Jamie,1980,48,Jamie,2009,500,452
Leana,1980,3069,Leana,2009,3521,452
Ivey,1980,3850,Ivey,2009,4302,452
Priscilla,1980,358,Priscilla,2009,812,454
Jeronimo,1980,3990,Jeronimo,2009,4444,454
Margot,1980,2301,Margot,2009,2756,455
Sabina,1980,2367,Sabina,2009,2824,457
Abbey,1980,1156,Abbey,2009,1614,458
Eliseo,1980,1785,Eliseo,2009,2244,459
Corey,1980,131,Corey,2009,594,463
Arthur,1980,304,Arthur,2009,767,463
Lea,1980,819,Lea,2009,1282,463
Adolfo,1980,1399,Adolfo,2009,1863,464
Evangelina,1980,1962,Evangelina,2009,2426,464
Jessie,1980,293,Jessie,2009,758,465
Kera,1980,4133,Kera,2009,4598,465
Kelly,1980,47,Kelly,2009,514,467
Alexandro,1980,2056,Alexandro,2009,2524,468
Darren,1980,340,Darren,2009,809,469
Lidia,1980,1820,Lidia,2009,2291,471
Jaime,1980,157,Jaime,2009,631,474
Lindsey,1980,178,Lindsey,2009,652,474
Courtney,1980,94,Courtney,2009,569,475
Desirae,1980,1361,Desirae,2009,1839,478
Cara,1980,401,Cara,2009,880,479
Ameerah,1980,4102,Ameerah,2009,4581,479
Randy,1980,179,Randy,2009,661,482
Gloria,1980,466,Gloria,2009,950,484
Shakira,1980,2048,Shakira,2009,2536,488
Aundrea,1980,2395,Aundrea,2009,2886,491
Kaleo,1980,4350,Kaleo,2009,4842,492
Jovanna,1980,3656,Jovanna,2009,4149,493
Jimmy,1980,260,Jimmy,2009,754,494
Walter,1980,281,Walter,2009,777,496
Kori,1980,1481,Kori,2009,1978,497
Wiley,1980,3356,Wiley,2009,3853,497
Karlos,1980,5360,Karlos,2009,5862,502
Terrell,1980,690,Terrell,2009,1194,504
Romel,1980,3768,Romel,2009,4273,505
Marlene,1980,853,Marlene,2009,1359,506
Anamaria,1980,3186,Anamaria,2009,3692,506
Stevie,1980,1583,Stevie,2009,2090,507
Tania,1980,796,Tania,2009,1304,508
Brittany,1980,364,Brittany,2009,873,509
Linnea,1980,2324,Linnea,2009,2834,510
Hinda,1980,4158,Hinda,2009,4669,511
Demarcus,1980,1207,Demarcus,2009,1721,514
Brenton,1980,1427,Brenton,2009,1941,514
Martez,1980,3265,Martez,2009,3779,514
Eddie,1980,370,Eddie,2009,888,518
Rosa,1980,406,Rosa,2009,925,519
Royce,1980,1567,Royce,2009,2088,521
Chaz,1980,1765,Chaz,2009,2290,525
Jayna,1980,2637,Jayna,2009,3162,525
Bridget,1980,299,Bridget,2009,826,527
Ramiro,1980,1002,Ramiro,2009,1529,527
Demetrius,1980,622,Demetrius,2009,1152,530
Alfonso,1980,843,Alfonso,2009,1373,530
Ishmael,1980,2701,Ishmael,2009,3231,530
Crystal,1980,49,Crystal,2009,580,531
Shayna,1980,1409,Shayna,2009,1940,531
Tiffany,1980,41,Tiffany,2009,573,532
Joelle,1980,1476,Joelle,2009,2008,532
Larissa,1980,869,Larissa,2009,1403,534
Daria,1980,2401,Daria,2009,2935,534
Bree,1980,1392,Bree,2009,1928,536
Claudia,1980,368,Claudia,2009,906,538
Whitney,1980,409,Whitney,2009,949,540
Angelique,1980,827,Angelique,2009,1369,542
Tony,1980,224,Tony,2009,768,544
Desiree,1980,305,Desiree,2009,849,544
Sylvia,1980,502,Sylvia,2009,1048,546
Rayshawn,1980,3181,Rayshawn,2009,3727,546
Mack,1980,1572,Mack,2009,2122,550
Apollo,1980,4547,Apollo,2009,5097,550
Farah,1980,2350,Farah,2009,2903,553
Erika,1980,173,Erika,2009,727,554
Franklin,1980,530,Franklin,2009,1085,555
Elisa,1980,633,Elisa,2009,1188,555
Phillip,1980,132,Phillip,2009,688,556
Damon,1980,523,Damon,2009,1081,558
Brenda,1980,231,Brenda,2009,794,563
Kirsten,1980,641,Kirsten,2009,1204,563
Luz,1980,845,Luz,2009,1410,565
Dustin,1980,79,Dustin,2009,645,566
Elvin,1980,1922,Elvin,2009,2489,567
Monica,1980,99,Monica,2009,667,568
Maurice,1980,342,Maurice,2009,910,568
Octavio,1980,1475,Octavio,2009,2043,568
Albert,1980,287,Albert,2009,856,569
Keith,1980,103,Keith,2009,673,570
Jay,1980,282,Jay,2009,853,571
Jelani,1980,2616,Jelani,2009,3188,572
Jerry,1980,189,Jerry,2009,763,574
Toby,1980,651,Toby,2009,1225,574
Jamal,1980,706,Jamal,2009,1281,575
Mikel,1980,1932,Mikel,2009,2507,575
Coral,1980,2229,Coral,2009,2804,575
Tzipora,1980,4309,Tzipora,2009,4886,577
Anissa,1980,2038,Anissa,2009,2619,581
Irene,1980,561,Irene,2009,1147,586
Irving,1980,2127,Irving,2009,2713,586
Cynthia,1980,128,Cynthia,2009,715,587
Dennis,1980,164,Dennis,2009,752,588
Anabel,1980,1429,Anabel,2009,2017,588
Ronald,1980,104,Ronald,2009,693,589
Rogelio,1980,884,Rogelio,2009,1473,589
Lance,1980,307,Lance,2009,898,591
Yitzchak,1980,3474,Yitzchak,2009,4065,591
Willian,1980,5787,Willian,2009,6380,593
Frankie,1980,830,Frankie,2009,1425,595
Hernan,1980,3130,Hernan,2009,3725,595
Kasey,1980,563,Kasey,2009,1159,596
Ignacio,1980,1194,Ignacio,2009,1793,599
Rex,1980,1057,Rex,2009,1657,600
Edith,1980,997,Edith,2009,1599,602
Ricky,1980,255,Ricky,2009,858,603
Colette,1980,1502,Colette,2009,2105,603
Rolando,1980,834,Rolando,2009,1439,605
Denis,1980,1894,Denis,2009,2499,605
Natasha,1980,177,Natasha,2009,783,606
Rosemary,1980,709,Rosemary,2009,1316,607
Ben,1980,767,Ben,2009,1374,607
Sonny,1980,1351,Sonny,2009,1958,607
Erica,1980,76,Erica,2009,684,608
Winnie,1980,3072,Winnie,2009,3681,609
Melvin,1980,454,Melvin,2009,1067,613
Holly,1980,114,Holly,2009,728,614
Elvis,1980,1271,Elvis,2009,1887,616
Marlyn,1980,3063,Marlyn,2009,3679,616
Donte,1980,1096,Donte,2009,1715,619
Kenny,1980,717,Kenny,2009,1337,620
Julie,1980,74,Julie,2009,696,622
Marlon,1980,744,Marlon,2009,1368,624
Augustine,1980,1841,Augustine,2009,2467,626
Curtis,1980,182,Curtis,2009,810,628
Efrain,1980,1087,Efrain,2009,1718,631
Brett,1980,191,Brett,2009,824,633
Philip,1980,170,Philip,2009,805,635
April,1980,61,April,2009,697,636
Raquel,1980,565,Raquel,2009,1202,637
Meredith,1980,275,Meredith,2009,915,640
Joana,1980,1808,Joana,2009,2448,640
Scott,1980,54,Scott,2009,695,641
Kristopher,1980,279,Kristopher,2009,920,641
Terrance,1980,375,Terrance,2009,1017,642
Larry,1980,143,Larry,2009,787,644
Alvin,1980,538,Alvin,2009,1182,644
Flor,1980,1829,Flor,2009,2475,646
Donald,1980,97,Donald,2009,746,649
Selina,1980,1242,Selina,2009,1892,650
Joy,1980,321,Joy,2009,972,651
Eleazar,1980,2501,Eleazar,2009,3152,651
Bruce,1980,328,Bruce,2009,980,652
Yitty,1980,3898,Yitty,2009,4550,652
Ashleigh,1980,1080,Ashleigh,2009,1738,658
Arlen,1980,4696,Arlen,2009,5354,658
Jeremi,1980,5740,Jeremi,2009,6400,660
Joe,1980,285,Joe,2009,946,661
Lawrence,1980,264,Lawrence,2009,929,665
Elisha,1980,642,Elisha,2009,1308,666
Lizandro,1980,4725,Lizandro,2009,5394,669
Jonathon,1980,356,Jonathon,2009,1028,672
Nancy,1980,220,Nancy,2009,894,674
Gilberto,1980,871,Gilberto,2009,1545,674
Denise,1980,194,Denise,2009,871,677
Carlo,1980,1451,Carlo,2009,2128,677
Trever,1980,2557,Trever,2009,3234,677
Myra,1980,937,Myra,2009,1616,679
Aisha,1980,682,Aisha,2009,1363,681
Rigoberto,1980,1243,Rigoberto,2009,1927,684
Judith,1980,705,Judith,2009,1391,686
Santos,1980,1223,Santos,2009,1920,697
Roxanna,1980,1875,Roxanna,2009,2572,697
Shekinah,1980,5358,Shekinah,2009,6058,700
Deon,1980,1098,Deon,2009,1802,704
Constantine,1980,3253,Constantine,2009,3960,707
Halima,1980,3958,Halima,2009,4666,708
Meghan,1980,228,Meghan,2009,940,712
Deshon,1980,5714,Deshon,2009,6432,718
Lacie,1980,1581,Lacie,2009,2300,719
Lisbet,1980,5606,Lisbet,2009,6325,719
Bernardo,1980,1574,Bernardo,2009,2295,721
Efren,1980,1751,Efren,2009,2473,722
Corinne,1980,658,Corinne,2009,1384,726
Ines,1980,2970,Ines,2009,3699,729
Ruthie,1980,3182,Ruthie,2009,3914,732
Aram,1980,3757,Aram,2009,4490,733
Russell,1980,185,Russell,2009,919,734
Salomon,1980,3118,Salomon,2009,3852,734
Lisandro,1980,3509,Lisandro,2009,4243,734
Kareem,1980,824,Kareem,2009,1559,735
Alycia,1980,1696,Alycia,2009,2433,737
Wade,1980,603,Wade,2009,1341,738
Cindy,1980,295,Cindy,2009,1035,740
Hiram,1980,2409,Hiram,2009,3151,742
Roger,1980,271,Roger,2009,1014,743
Gonzalo,1980,1636,Gonzalo,2009,2379,743
Marygrace,1980,4516,Marygrace,2009,5262,746
Yaneth,1980,5446,Yaneth,2009,6195,749
Rene,1980,534,Rene,2009,1284,750
Shoshana,1980,2160,Shoshana,2009,2912,752
Rudy,1980,804,Rudy,2009,1558,754
Jovan,1980,1155,Jovan,2009,1914,759
Omer,1980,4891,Omer,2009,5651,760
Mahogany,1980,2972,Mahogany,2009,3733,761
Tommy,1980,405,Tommy,2009,1167,762
Fabiola,1980,1790,Fabiola,2009,2552,762
Ellen,1980,494,Ellen,2009,1258,764
Abdul,1980,1918,Abdul,2009,2682,764
Yocheved,1980,3303,Yocheved,2009,4067,764
Jamar,1980,806,Jamar,2009,1573,767
Nestor,1980,1731,Nestor,2009,2501,770
Raizel,1980,3442,Raizel,2009,4213,771
Gwen,1980,1491,Gwen,2009,2264,773
Rodney,1980,251,Rodney,2009,1025,774
Terrence,1980,428,Terrence,2009,1203,775
Eulalia,1980,5566,Eulalia,2009,6341,775
Anastacia,1980,3380,Anastacia,2009,4156,776
Sterling,1980,1219,Sterling,2009,1996,777
Maxine,1980,2043,Maxine,2009,2822,779
Marie,1980,286,Marie,2009,1070,784
Frederick,1980,332,Frederick,2009,1116,784
Eileen,1980,696,Eileen,2009,1480,784
Anisha,1980,2534,Anisha,2009,3319,785
Kamal,1980,2747,Kamal,2009,3532,785
Roland,1980,811,Roland,2009,1604,793
Micheal,1980,266,Micheal,2009,1060,794
Joao,1980,3624,Joao,2009,4418,794
Yechezkel,1980,5315,Yechezkel,2009,6110,795
Zalman,1980,5319,Zalman,2009,6114,795
Krystal,1980,432,Krystal,2009,1232,800
Kacey,1980,1478,Kacey,2009,2279,801
Anne,1980,221,Anne,2009,1023,802
Xochilt,1980,4214,Xochilt,2009,5019,805
Stefan,1980,1309,Stefan,2009,2115,806
Miri,1980,4839,Miri,2009,5645,806
Meyer,1980,5290,Meyer,2009,6096,806
Wendy,1980,149,Wendy,2009,956,807
Michal,1980,2768,Michal,2009,3578,810
Azucena,1980,2628,Azucena,2009,3442,814
Sindy,1980,3891,Sindy,2009,4706,815
Louisa,1980,1991,Louisa,2009,2807,816
Joey,1980,412,Joey,2009,1229,817
Laci,1980,1644,Laci,2009,2461,817
Marisa,1980,460,Marisa,2009,1280,820
Kristina,1980,148,Kristina,2009,969,821
Linda,1980,219,Linda,2009,1041,822
Aida,1980,1538,Aida,2009,2361,823
Montrell,1980,2481,Montrell,2009,3304,823
Virginia,1980,316,Virginia,2009,1142,826
Sandra,1980,160,Sandra,2009,987,827
Hugh,1980,1318,Hugh,2009,2147,829
Adrienne,1980,327,Adrienne,2009,1158,831
Gary,1980,120,Gary,2009,953,833
Dereck,1980,1803,Dereck,2009,2636,833
Reuben,1980,1162,Reuben,2009,1997,835
Deanna,1980,297,Deanna,2009,1135,838
Sonia,1980,417,Sonia,2009,1255,838
Elaine,1980,588,Elaine,2009,1428,840
Stormy,1980,2177,Stormy,2009,3017,840
Esau,1980,3760,Esau,2009,4602,842
Amberly,1980,1787,Amberly,2009,2631,844
Luana,1980,4348,Luana,2009,5192,844
Harry,1980,540,Harry,2009,1385,845
Boruch,1980,3903,Boruch,2009,4748,845
Reanna,1980,2624,Reanna,2009,3470,846
Thea,1980,1878,Thea,2009,2726,848
Lindsay,1980,141,Lindsay,2009,993,852
Rachael,1980,274,Rachael,2009,1126,852
Belinda,1980,639,Belinda,2009,1491,852
Delia,1980,1094,Delia,2009,1949,855
Nabil,1980,5756,Nabil,2009,6611,855
Ray,1980,557,Ray,2009,1416,859
Carl,1980,208,Carl,2009,1068,860
Humberto,1980,1081,Humberto,2009,1943,862
Jermaine,1980,302,Jermaine,2009,1165,863
Roy,1980,311,Roy,2009,1175,864
Jasson,1980,5738,Jasson,2009,6605,867
Gino,1980,1595,Gino,2009,2463,868
Kyndra,1980,5592,Kyndra,2009,6460,868
Ivette,1980,1515,Ivette,2009,2385,870
Dana,1980,125,Dana,2009,997,872
Marshal,1980,3991,Marshal,2009,4863,872
Douglas,1980,118,Douglas,2009,991,873
Gareth,1980,5727,Gareth,2009,6600,873
Marcellus,1980,3258,Marcellus,2009,4132,874
Aleida,1980,3595,Aleida,2009,4469,874
Francesco,1980,1578,Francesco,2009,2457,879
Maura,1980,1244,Maura,2009,2125,881
Cory,1980,166,Cory,2009,1049,883
Mike,1980,909,Mike,2009,1794,885
Shannon,1980,64,Shannon,2009,951,887
Martha,1980,341,Martha,2009,1228,887
Leif,1980,1646,Leif,2009,2533,887
Westley,1980,2525,Westley,2009,3412,887
Lizette,1980,1302,Lizette,2009,2190,888
Fidel,1980,1779,Fidel,2009,2669,890
Rashaad,1980,3034,Rashaad,2009,3924,890
Kathleen,1980,163,Kathleen,2009,1057,894
Steve,1980,418,Steve,2009,1312,894
Rohit,1980,4319,Rohit,2009,5214,895
Ambrose,1980,5696,Ambrose,2009,6592,896
Shaun,1980,161,Shaun,2009,1062,901
Reginald,1980,350,Reginald,2009,1252,902
Patricia,1980,112,Patricia,2009,1015,903
Tabitha,1980,308,Tabitha,2009,1214,906
Jamel,1980,1109,Jamel,2009,2015,906
Hashim,1980,4875,Hashim,2009,5781,906
Shifra,1980,3470,Shifra,2009,4377,907
Faye,1980,2158,Faye,2009,3067,909
Cristina,1980,407,Cristina,2009,1317,910
Graciela,1980,1164,Graciela,2009,2075,911
Heath,1980,518,Heath,2009,1430,912
Alma,1980,655,Alma,2009,1567,912
Jevon,1980,2654,Jevon,2009,3567,913
Keoni,1980,3039,Keoni,2009,3954,915
Ike,1980,4055,Ike,2009,4970,915
Lewis,1980,664,Lewis,2009,1582,918
Silvia,1980,982,Silvia,2009,1901,919
Yamile,1980,4224,Yamile,2009,5143,919
Kristen,1980,89,Kristen,2009,1010,921
Isacc,1980,3566,Isacc,2009,4491,925
Sunny,1980,1430,Sunny,2009,2356,926
Carissa,1980,616,Carissa,2009,1543,927
Leora,1980,3507,Leora,2009,4435,928
Sequoia,1980,4537,Sequoia,2009,5470,933
Benzion,1980,4313,Benzion,2009,5251,938
Anabell,1980,3368,Anabell,2009,4307,939
Lamar,1980,683,Lamar,2009,1625,942
Stanley,1980,461,Stanley,2009,1407,946
Frances,1980,504,Frances,2009,1450,946
Nikita,1980,1494,Nikita,2009,2440,946
Jamil,1980,1519,Jamil,2009,2470,951
Marc,1980,249,Marc,2009,1201,952
Hasan,1980,2386,Hasan,2009,3338,952
Jeffery,1980,183,Jeffery,2009,1136,953
Terry,1980,186,Terry,2009,1140,954
Blair,1980,977,Blair,2009,1932,955
Neil,1980,376,Neil,2009,1332,956
Arleen,1980,3378,Arleen,2009,4334,956
Bobby,1980,223,Bobby,2009,1180,957
Carla,1980,300,Carla,2009,1257,957
Shayne,1980,1645,Shayne,2009,2604,959
Salvatore,1980,916,Salvatore,2009,1879,963
Maceo,1980,5065,Maceo,2009,6029,964
Rashawn,1980,2131,Rashawn,2009,3096,965
Deron,1980,2659,Deron,2009,3626,967
Lael,1980,5504,Lael,2009,6472,968
Darnell,1980,758,Darnell,2009,1727,969
Pepper,1980,4333,Pepper,2009,5303,970
Leandre,1980,5064,Leandre,2009,6035,971
Barbara,1980,237,Barbara,2009,1210,973
Jon,1980,261,Jon,2009,1234,973
Coy,1980,1873,Coy,2009,2848,975
Francis,1980,492,Francis,2009,1469,977
Lara,1980,702,Lara,2009,1683,981
Trista,1980,1446,Trista,2009,2428,982
Honey,1980,3328,Honey,2009,4310,982
Verenice,1980,4544,Verenice,2009,5526,982
Carolyn,1980,290,Carolyn,2009,1274,984
Rodolfo,1980,729,Rodolfo,2009,1713,984
Delina,1980,5559,Delina,2009,6543,984
Chad,1980,68,Chad,2009,1053,985
Isidro,1980,1930,Isidro,2009,2916,986
Jacquelin,1980,2320,Jacquelin,2009,3307,987
Justine,1980,1041,Justine,2009,2031,990
Mayra,1980,526,Mayra,2009,1531,1005
Ambar,1980,3313,Ambar,2009,4319,1006
Shaina,1980,2097,Shaina,2009,3106,1009
Jedidiah,1980,1382,Jedidiah,2009,2392,1010
Thaddeus,1980,1187,Thaddeus,2009,2198,1011
Heather,1980,23,Heather,2009,1036,1013
Pilar,1980,2392,Pilar,2009,3405,1013
Pierre,1980,1133,Pierre,2009,2151,1018
Naim,1980,2947,Naim,2009,3967,1020
Reynaldo,1980,1058,Reynaldo,2009,2079,1021
Naeem,1980,3278,Naeem,2009,4300,1022
Teresa,1980,192,Teresa,2009,1215,1023
Gerald,1980,303,Gerald,2009,1326,1023
Janice,1980,491,Janice,2009,1519,1028
Willie,1980,262,Willie,2009,1291,1029
Zully,1980,4692,Zully,2009,5721,1029
Ronnie,1980,360,Ronnie,2009,1390,1030
Benuel,1980,4429,Benuel,2009,5459,1030
Alisa,1980,672,Alisa,2009,1705,1033
Billy,1980,203,Billy,2009,1237,1034
Chanelle,1980,2122,Chanelle,2009,3156,1034
Jerome,1980,373,Jerome,2009,1408,1035
Dwayne,1980,462,Dwayne,2009,1497,1035
Niya,1980,2581,Niya,2009,3616,1035
Jessenia,1980,2022,Jessenia,2009,3059,1037
Reva,1980,5127,Reva,2009,6166,1039
Domenick,1980,3811,Domenick,2009,4851,1040
Nachman,1980,4416,Nachman,2009,5456,1040
Antwan,1980,880,Antwan,2009,1922,1042
Jacy,1980,4077,Jacy,2009,5119,1042
Tyrone,1980,426,Tyrone,2009,1470,1044
Nakiya,1980,5228,Nakiya,2009,6273,1045
Keyana,1980,3067,Keyana,2009,4113,1046
Regina,1980,277,Regina,2009,1324,1047
Charity,1980,468,Charity,2009,1515,1047
Rosario,1980,1433,Rosario,2009,2480,1047
Cedric,1980,515,Cedric,2009,1565,1050
Anton,1980,1113,Anton,2009,2166,1053
Nathanial,1980,1416,Nathanial,2009,2469,1053
Montavious,1980,5013,Montavious,2009,6066,1053
Kacie,1980,1464,Kacie,2009,2520,1056
Christine,1980,92,Christine,2009,1151,1059
Antoine,1980,604,Antoine,2009,1663,1059
Rocio,1980,965,Rocio,2009,2026,1061
Amos,1980,1195,Amos,2009,2256,1061
Isaura,1980,3959,Isaura,2009,5020,1061
Oren,1980,2798,Oren,2009,3864,1066
Lesli,1980,2521,Lesli,2009,3591,1070
Joyce,1980,620,Joyce,2009,1694,1074
Kaci,1980,1536,Kaci,2009,2611,1075
Marian,1980,1348,Marian,2009,2424,1076
Maile,1980,2568,Maile,2009,3647,1079
Jashua,1980,4714,Jashua,2009,5794,1080
Adina,1980,1773,Adina,2009,2854,1081
Fabio,1980,3524,Fabio,2009,4605,1081
Jenny,1980,230,Jenny,2009,1314,1084
Nellie,1980,1811,Nellie,2009,2896,1085
Everardo,1980,2460,Everardo,2009,3545,1085
Marshaun,1980,4357,Marshaun,2009,5442,1085
Keanna,1980,3614,Keanna,2009,4702,1088
Celina,1980,1218,Celina,2009,2307,1089
Shay,1980,1691,Shay,2009,2780,1089
Marcoantonio,1980,4221,Marcoantonio,2009,5319,1098
Derick,1980,733,Derick,2009,1834,1101
Jacklyn,1980,1303,Jacklyn,2009,2404,1101
Oriana,1980,3927,Oriana,2009,5028,1101
Misha,1980,2297,Misha,2009,3403,1106
Bronwyn,1980,3728,Bronwyn,2009,4835,1107
Janie,1980,1025,Janie,2009,2139,1114
Alisha,1980,296,Alisha,2009,1412,1116
Elana,1980,1848,Elana,2009,2964,1116
Garret,1980,1706,Garret,2009,2830,1124
Janet,1980,334,Janet,2009,1459,1125
Rashard,1980,2840,Rashard,2009,3965,1125
Jalene,1980,4618,Jalene,2009,5743,1125
Javaris,1980,4752,Javaris,2009,5877,1125
Maribel,1980,584,Maribel,2009,1710,1126
Tyra,1980,1593,Tyra,2009,2721,1128
Yajaira,1980,1783,Yajaira,2009,2913,1130
Lorena,1980,571,Lorena,2009,1703,1132
Paula,1980,335,Paula,2009,1468,1133
Lenny,1980,2139,Lenny,2009,3272,1133
Lourdes,1980,1262,Lourdes,2009,2396,1134
Star,1980,1565,Star,2009,2702,1137
Leonard,1980,395,Leonard,2009,1534,1139
Richie,1980,3215,Richie,2009,4355,1140
Brittney,1980,820,Brittney,2009,1961,1141
Brent,1980,171,Brent,2009,1322,1151
Susanna,1980,1246,Susanna,2009,2401,1155
Ivory,1980,2193,Ivory,2009,3350,1157
Tara,1980,96,Tara,2009,1263,1167
Gilbert,1980,568,Gilbert,2009,1737,1169
Raymundo,1980,1545,Raymundo,2009,2714,1169
Denver,1980,2091,Denver,2009,3260,1169
Schuyler,1980,5304,Schuyler,2009,6474,1170
Jamon,1980,3036,Jamon,2009,4207,1171
Magali,1980,3220,Magali,2009,4392,1172
Petra,1980,1885,Petra,2009,3060,1175
Flora,1980,2145,Flora,2009,3322,1177
Naimah,1980,3054,Naimah,2009,4234,1180
Sharon,1980,246,Sharon,2009,1429,1183
Laurel,1980,809,Laurel,2009,1992,1183
Lee,1980,216,Lee,2009,1400,1184
Arlene,1980,925,Arlene,2009,2110,1185
Charis,1980,3197,Charis,2009,4382,1185
Deborah,1980,289,Deborah,2009,1484,1195
Margarita,1980,832,Margarita,2009,2027,1195
Debora,1980,2417,Debora,2009,3612,1195
Dameon,1980,2037,Dameon,2009,3233,1196
Renee,1980,213,Renee,2009,1411,1198
Chantal,1980,2069,Chantal,2009,3267,1198
Susana,1980,858,Susana,2009,2058,1200
Joan,1980,888,Joan,2009,2091,1203
Joshuah,1980,3212,Joshuah,2009,4420,1208
Beatriz,1980,1140,Beatriz,2009,2350,1210
Cassie,1980,580,Cassie,2009,1792,1212
Nick,1980,1061,Nick,2009,2275,1214
Marcela,1980,1576,Marcela,2009,2790,1214
Chasity,1980,562,Chasity,2009,1782,1220
Marques,1980,1276,Marques,2009,2496,1220
Catarina,1980,3954,Catarina,2009,5174,1220
Jarrett,1980,899,Jarrett,2009,2120,1221
Jacquelyn,1980,479,Jacquelyn,2009,1701,1222
Aimee,1980,333,Aimee,2009,1561,1228
Lisa,1980,44,Lisa,2009,1273,1229
Lazaro,1980,1744,Lazaro,2009,2974,1230
Darrell,1980,351,Darrell,2009,1588,1237
Nadine,1980,1012,Nadine,2009,2250,1238
Jessy,1980,2375,Jessy,2009,3620,1245
Moira,1980,2161,Moira,2009,3407,1246
Dion,1980,1146,Dion,2009,2393,1247
Raheem,1980,1487,Raheem,2009,2736,1249
Della,1980,2211,Della,2009,3462,1251
Noemy,1980,4255,Noemy,2009,5506,1251
Eugene,1980,391,Eugene,2009,1643,1252
Stefania,1980,4116,Stefania,2009,5368,1252
Juana,1980,1279,Juana,2009,2535,1256
Crispin,1980,4959,Crispin,2009,6215,1256
Tia,1980,449,Tia,2009,1706,1257
Susan,1980,129,Susan,2009,1387,1258
Aviva,1980,2647,Aviva,2009,3905,1258
Giuseppe,1980,1880,Giuseppe,2009,3142,1262
Rhiannon,1980,906,Rhiannon,2009,2169,1263
Tavaris,1980,2755,Tavaris,2009,4020,1265
Ervin,1980,1530,Ervin,2009,2796,1266
Elissa,1980,949,Elissa,2009,2216,1267
Nuvia,1980,4212,Nuvia,2009,5480,1268
Antonia,1980,933,Antonia,2009,2202,1269
Jacinda,1980,4022,Jacinda,2009,5291,1269
Demarco,1980,2011,Demarco,2009,3281,1270
Antwone,1980,4068,Antwone,2009,5343,1275
Ayesha,1980,1695,Ayesha,2009,2972,1277
Armon,1980,4069,Armon,2009,5348,1279
Clay,1980,941,Clay,2009,2222,1281
Viola,1980,2189,Viola,2009,3471,1282
Osbaldo,1980,2989,Osbaldo,2009,4271,1282
Starr,1980,1338,Starr,2009,2624,1286
Angelena,1980,4191,Angelena,2009,5478,1287
Alfred,1980,546,Alfred,2009,1836,1290
Eunice,1980,1462,Eunice,2009,2753,1291
Johnpaul,1980,1846,Johnpaul,2009,3137,1291
Gretchen,1980,511,Gretchen,2009,1805,1294
Craig,1980,147,Craig,2009,1443,1296
Roxanne,1980,536,Roxanne,2009,1832,1296
Geneva,1980,1168,Geneva,2009,2464,1296
Randall,1980,278,Randall,2009,1576,1298
Stormi,1980,5437,Stormi,2009,6735,1298
Marion,1980,955,Marion,2009,2255,1300
Blanca,1980,768,Blanca,2009,2069,1301
Geronimo,1980,3139,Geronimo,2009,4440,1301
Josh,1980,814,Josh,2009,2118,1304
Korey,1980,1347,Korey,2009,2652,1305
Aura,1980,3191,Aura,2009,4499,1308
Arie,1980,4406,Arie,2009,5716,1310
Isela,1980,1884,Isela,2009,3199,1315
Jolene,1980,621,Jolene,2009,1937,1316
Maha,1980,5124,Maha,2009,6441,1317
Sheldon,1980,1039,Sheldon,2009,2358,1319
Roderick,1980,609,Roderick,2009,1929,1320
Renata,1980,627,Renata,2009,1947,1320
Yohana,1980,4691,Yohana,2009,6012,1321
Sahar,1980,4666,Sahar,2009,5989,1323
Valente,1980,3522,Valente,2009,4849,1327
Wes,1980,3773,Wes,2009,5101,1328
Emile,1980,3780,Emile,2009,5108,1328
Katrina,1980,180,Katrina,2009,1510,1330
Merari,1980,3962,Merari,2009,5294,1332
Tova,1980,4308,Tova,2009,5642,1334
Sally,1980,607,Sally,2009,1948,1341
Cinthia,1980,2440,Cinthia,2009,3783,1343
Jordana,1980,2495,Jordana,2009,3839,1344
Salim,1980,3982,Salim,2009,5327,1345
Keona,1980,4026,Keona,2009,5372,1346
Marleen,1980,5164,Marleen,2009,6510,1346
Nicolette,1980,915,Nicolette,2009,2263,1348
Nohemi,1980,3229,Nohemi,2009,4577,1348
Tamir,1980,3893,Tamir,2009,5248,1355
Annamarie,1980,1755,Annamarie,2009,3112,1357
Yoana,1980,3539,Yoana,2009,4896,1357
Bridgette,1980,847,Bridgette,2009,2205,1358
Milton,1980,885,Milton,2009,2243,1358
Carmela,1980,1756,Carmela,2009,3120,1364
Rahul,1980,3242,Rahul,2009,4607,1365
Stacy,1980,115,Stacy,2009,1483,1368
Jan,1980,1216,Jan,2009,2584,1368
Divina,1980,4602,Divina,2009,5971,1369
Rosie,1980,1557,Rosie,2009,2927,1370
Heriberto,1980,1314,Heriberto,2009,2691,1377
Wayne,1980,298,Wayne,2009,1677,1379
Davina,1980,1607,Davina,2009,2986,1379
Shirley,1980,692,Shirley,2009,2072,1380
Darryl,1980,549,Darryl,2009,1930,1381
Alysia,1980,1612,Alysia,2009,2995,1383
Nada,1980,3343,Nada,2009,4729,1386
Lionel,1980,1067,Lionel,2009,2455,1388
Kendell,1980,2671,Kendell,2009,4063,1392
Pamela,1980,172,Pamela,2009,1569,1397
Marcell,1980,2655,Marcell,2009,4052,1397
Hollis,1980,3140,Hollis,2009,4538,1398
Harold,1980,427,Harold,2009,1827,1400
Mitchel,1980,2361,Mitchel,2009,3761,1400
Desiray,1980,4600,Desiray,2009,6001,1401
Dina,1980,882,Dina,2009,2285,1403
Katy,1980,764,Katy,2009,2168,1404
Thor,1980,3828,Thor,2009,5233,1405
Annmarie,1980,1234,Annmarie,2009,2644,1410
Ceasar,1980,3027,Ceasar,2009,4438,1411
Moishe,1980,3597,Moishe,2009,5010,1413
Lacy,1980,710,Lacy,2009,2126,1416
Daron,1980,1863,Daron,2009,3279,1416
Aurelio,1980,2216,Aurelio,2009,3633,1417
Benny,1980,1091,Benny,2009,2511,1420
Dajuan,1980,2883,Dajuan,2009,4304,1421
Rosalyn,1980,1330,Rosalyn,2009,2754,1424
Lucio,1980,2376,Lucio,2009,3802,1426
Ester,1980,2186,Ester,2009,3613,1427
Annalisa,1980,2253,Annalisa,2009,3680,1427
Hillel,1980,3822,Hillel,2009,5249,1427
Claudio,1980,2001,Claudio,2009,3431,1430
Mari,1980,1526,Mari,2009,2958,1432
Judson,1980,1715,Judson,2009,3148,1433
Harvey,1980,1123,Harvey,2009,2557,1434
Darlene,1980,657,Darlene,2009,2096,1439
Luiz,1980,3204,Luiz,2009,4643,1439
Lars,1980,2311,Lars,2009,3751,1440
Dorothy,1980,528,Dorothy,2009,1969,1441
Amberlee,1980,3751,Amberlee,2009,5195,1444
Baruch,1980,3305,Baruch,2009,4751,1446
Tzirel,1980,5255,Tzirel,2009,6708,1453
Lamont,1980,786,Lamont,2009,2240,1454
Ann,1980,263,Ann,2009,1728,1465
Maricruz,1980,3102,Maricruz,2009,4567,1465
Jana,1980,469,Jana,2009,1935,1466
Tamara,1980,218,Tamara,2009,1688,1470
Fausto,1980,2725,Fausto,2009,4197,1472
Lesley,1980,507,Lesley,2009,1981,1474
Jean,1980,559,Jean,2009,2033,1474
Theresa,1980,210,Theresa,2009,1686,1476
Mai,1980,3103,Mai,2009,4582,1479
Armand,1980,3573,Armand,2009,5056,1483
Christan,1980,4131,Christan,2009,5615,1484
Hamilton,1980,2505,Hamilton,2009,3990,1485
Ernest,1980,372,Ernest,2009,1858,1486
Annette,1980,499,Annette,2009,1985,1486
Cornelius,1980,851,Cornelius,2009,2337,1486
Azalia,1980,4325,Azalia,2009,5818,1493
Leticia,1980,477,Leticia,2009,1971,1494
Roslyn,1980,2213,Roslyn,2009,3716,1503
Fredrick,1980,680,Fredrick,2009,2188,1508
Laron,1980,2024,Laron,2009,3533,1509
Pricilla,1980,2490,Pricilla,2009,3999,1509
Christos,1980,2471,Christos,2009,3984,1513
Ramsey,1980,2150,Ramsey,2009,3665,1515
Gregorio,1980,1529,Gregorio,2009,3046,1517
Mahlon,1980,3834,Mahlon,2009,5352,1518
Morris,1980,1396,Morris,2009,2922,1526
Forrest,1980,1026,Forrest,2009,2553,1527
Dennise,1980,3065,Dennise,2009,4592,1527
Sammy,1980,960,Sammy,2009,2488,1528
Denton,1980,4960,Denton,2009,6488,1528
Leobardo,1980,2913,Leobardo,2009,4442,1529
Leroy,1980,635,Leroy,2009,2165,1530
Adelaida,1980,3744,Adelaida,2009,5277,1533
Mikala,1980,5156,Mikala,2009,6690,1534
Leandra,1980,2396,Leandra,2009,3931,1535
Cris,1980,5707,Cris,2009,7246,1539
Louie,1980,1655,Louie,2009,3197,1542
Donna,1980,280,Donna,2009,1829,1549
Serafin,1980,4222,Serafin,2009,5771,1549
Marciano,1980,4970,Marciano,2009,6520,1550
Genaro,1980,1844,Genaro,2009,3399,1555
Rico,1980,1315,Rico,2009,2871,1556
Armen,1980,3758,Armen,2009,5314,1556
Jamilah,1980,4504,Jamilah,2009,6062,1558
Bernard,1980,597,Bernard,2009,2171,1574
Lucinda,1980,1095,Lucinda,2009,2674,1579
Ross,1980,474,Ross,2009,2054,1580
Alysha,1980,2136,Alysha,2009,3717,1581
Gordon,1980,747,Gordon,2009,2330,1583
Ileana,1980,2448,Ileana,2009,4031,1583
Tyron,1980,1804,Tyron,2009,3394,1590
Mahealani,1980,4758,Mahealani,2009,6349,1591
Mariel,1980,1602,Mariel,2009,3195,1593
Samad,1980,5183,Samad,2009,6777,1594
Jerrell,1980,2288,Jerrell,2009,3883,1595
Tanya,1980,176,Tanya,2009,1778,1602
Paulo,1980,2073,Paulo,2009,3678,1605
Tyreese,1980,5356,Tyreese,2009,6961,1605
Gina,1980,204,Gina,2009,1815,1611
Anibal,1980,2506,Anibal,2009,4117,1611
Jarvis,1980,973,Jarvis,2009,2586,1613
Howard,1980,517,Howard,2009,2132,1615
Benjamen,1980,3974,Benjamen,2009,5591,1617
Audra,1980,769,Audra,2009,2388,1619
Erwin,1980,1940,Erwin,2009,3559,1619
Rosalia,1980,1887,Rosalia,2009,3511,1624
Sione,1980,3425,Sione,2009,5053,1628
Sonya,1980,421,Sonya,2009,2050,1629
Krista,1980,238,Krista,2009,1868,1630
Dejuan,1980,1871,Dejuan,2009,3501,1630
Zulema,1980,2540,Zulema,2009,4170,1630
Stephan,1980,1097,Stephan,2009,2728,1631
Ralph,1980,478,Ralph,2009,2111,1633
Yvette,1980,541,Yvette,2009,2176,1635
Dianna,1980,908,Dianna,2009,2543,1635
Liz,1980,2397,Liz,2009,4037,1640
Abe,1980,5447,Abe,2009,7088,1641
Nile,1980,4731,Nile,2009,6374,1643
Dale,1980,400,Dale,2009,2044,1644
Marcelino,1980,2100,Marcelino,2009,3744,1644
Josef,1980,1627,Josef,2009,3277,1650
Sandy,1980,527,Sandy,2009,2178,1651
Elam,1980,3602,Elam,2009,5256,1654
Alain,1980,2465,Alain,2009,4121,1656
Kathy,1980,486,Kathy,2009,2144,1658
Constance,1980,950,Constance,2009,2609,1659
Simona,1980,2775,Simona,2009,4436,1661
Alton,1980,1163,Alton,2009,2827,1664
Arun,1980,5266,Arun,2009,6933,1667
Perry,1980,854,Perry,2009,2534,1680
Marcella,1980,994,Marcella,2009,2675,1681
Ivonne,1980,2092,Ivonne,2009,3775,1683
Lino,1980,2729,Lino,2009,4413,1684
Elizabet,1980,4605,Elizabet,2009,6289,1684
Meagan,1980,615,Meagan,2009,2301,1686
Mariaelena,1980,3321,Mariaelena,2009,5016,1695
Vicky,1980,1206,Vicky,2009,2902,1696
Dewayne,1980,840,Dewayne,2009,2537,1697
Hillary,1980,550,Hillary,2009,2248,1698
Aja,1980,1048,Aja,2009,2746,1698
Shaheem,1980,5306,Shaheem,2009,7012,1706
Caterina,1980,3331,Caterina,2009,5045,1714
Barron,1980,3146,Barron,2009,4866,1720
Shaindel,1980,4393,Shaindel,2009,6115,1722
Karl,1980,472,Karl,2009,2196,1724
Rocky,1980,698,Rocky,2009,2425,1727
Ken,1980,1845,Ken,2009,3572,1727
Fannie,1980,2482,Fannie,2009,4211,1729
Ericka,1980,647,Ericka,2009,2377,1730
Yesica,1980,4264,Yesica,2009,5995,1731
Dwight,1980,760,Dwight,2009,2495,1735
Khadijah,1980,2373,Khadijah,2009,4108,1735
Rafaela,1980,3230,Rafaela,2009,4967,1737
Kristin,1980,85,Kristin,2009,1824,1739
Elysia,1980,2422,Elysia,2009,4166,1744
Katheryn,1980,1956,Katheryn,2009,3707,1751
Von,1980,3639,Von,2009,5398,1759
Monique,1980,193,Monique,2009,1955,1762
Benito,1980,1374,Benito,2009,3138,1764
Clarence,1980,543,Clarence,2009,2310,1767
Georgina,1980,1259,Georgina,2009,3027,1768
Tamar,1980,2120,Tamar,2009,3891,1771
Johannes,1980,3978,Johannes,2009,5751,1773
Anita,1980,436,Anita,2009,2220,1784
Lizet,1980,2366,Lizet,2009,4151,1785
Nubia,1980,2678,Nubia,2009,4463,1785
Kami,1980,1069,Kami,2009,2858,1789
Maryann,1980,1077,Maryann,2009,2866,1789
Echo,1980,3937,Echo,2009,5730,1793
Eusebio,1980,4962,Eusebio,2009,6756,1794
Armin,1980,5449,Armin,2009,7243,1794
Arik,1980,5135,Arik,2009,6931,1796
Desi,1980,3775,Desi,2009,5572,1797
Riva,1980,5640,Riva,2009,7440,1800
Takiyah,1980,3271,Takiyah,2009,5075,1804
Carrie,1980,105,Carrie,2009,1910,1805
Candy,1980,839,Candy,2009,2646,1807
Yoel,1980,1517,Yoel,2009,3330,1813
Lamarcus,1980,2848,Lamarcus,2009,4662,1814
Clinton,1980,265,Clinton,2009,2081,1816
Dagoberto,1980,3579,Dagoberto,2009,5396,1817
Martina,1980,1300,Martina,2009,3119,1819
Loren,1980,801,Loren,2009,2628,1827
Geno,1980,3588,Geno,2009,5418,1830
Serina,1980,1954,Serina,2009,3786,1832
Gerard,1980,979,Gerard,2009,2814,1835
Brandy,1980,95,Brandy,2009,1934,1839
Colleen,1980,269,Colleen,2009,2112,1843
Robin,1980,188,Robin,2009,2040,1852
Maricela,1980,969,Maricela,2009,2828,1859
Lynette,1980,856,Lynette,2009,2716,1860
Toni,1980,352,Toni,2009,2215,1863
Rhoda,1980,3401,Rhoda,2009,5267,1866
Bernabe,1980,4957,Bernabe,2009,6824,1867
Todd,1980,150,Todd,2009,2019,1869
Murphy,1980,4364,Murphy,2009,6234,1870
Harriet,1980,3094,Harriet,2009,4965,1871
Theron,1980,2256,Theron,2009,4129,1873
Kezia,1980,4243,Kezia,2009,6117,1874
Marguerite,1980,2634,Marguerite,2009,4509,1875
Rosalinda,1980,1144,Rosalinda,2009,3021,1877
Katharine,1980,731,Katharine,2009,2610,1879
Rita,1980,556,Rita,2009,2436,1880
Terence,1980,904,Terence,2009,2786,1882
Lashay,1980,4803,Lashay,2009,6687,1884
Cami,1980,2571,Cami,2009,4457,1886
Norman,1980,617,Norman,2009,2505,1888
Carol,1980,452,Carol,2009,2342,1890
Amin,1980,2468,Amin,2009,4360,1892
Antwon,1980,1499,Antwon,2009,3393,1894
Delonte,1980,3534,Delonte,2009,5428,1894
Sarena,1980,4667,Sarena,2009,6561,1894
Janell,1980,990,Janell,2009,2885,1895
Kris,1980,1272,Kris,2009,3168,1896
Jaclyn,1980,324,Jaclyn,2009,2221,1897
Lyndsey,1980,1170,Lyndsey,2009,3068,1898
Julienne,1980,4625,Julienne,2009,6529,1904
Rina,1980,2249,Rina,2009,4158,1909
Odessa,1980,4035,Odessa,2009,5946,1911
Candace,1980,259,Candace,2009,2172,1913
Ira,1980,1175,Ira,2009,3088,1913
Sandro,1980,3408,Sandro,2009,5321,1913
Fatimah,1980,2483,Fatimah,2009,4397,1914
Joi,1980,1613,Joi,2009,3528,1915
Jaymie,1980,2762,Jaymie,2009,4679,1917
Merlin,1980,4568,Merlin,2009,6487,1919
Nikki,1980,473,Nikki,2009,2397,1924
Gladys,1980,1100,Gladys,2009,3029,1929
Myriam,1980,3018,Myriam,2009,4947,1929
Federico,1980,1561,Federico,2009,3495,1934
Tina,1980,145,Tina,2009,2084,1939
Adria,1980,1675,Adria,2009,3617,1942
Katty,1980,5212,Katty,2009,7157,1945
Markanthony,1980,4277,Markanthony,2009,6224,1947
Jackie,1980,451,Jackie,2009,2399,1948
Reyes,1980,2052,Reyes,2009,4000,1948
Betsy,1980,748,Betsy,2009,2699,1951
Arnold,1980,1185,Arnold,2009,3136,1951
Camellia,1980,4588,Camellia,2009,6540,1952
Nikolaos,1980,4121,Nikolaos,2009,6075,1954
Rosella,1980,4535,Rosella,2009,6490,1955
Athanasios,1980,4118,Athanasios,2009,6076,1958
Ronny,1980,1995,Ronny,2009,3957,1962
Blimie,1980,4818,Blimie,2009,6781,1963
Nicklas,1980,4143,Nicklas,2009,6107,1964
Tom,1980,1284,Tom,2009,3249,1965
Estela,1980,1726,Estela,2009,3693,1967
Destinie,1980,3936,Destinie,2009,5903,1967
Tyrus,1980,3013,Tyrus,2009,4985,1972
Silvestre,1980,3245,Silvestre,2009,5217,1972
Cuauhtemoc,1980,3077,Cuauhtemoc,2009,5050,1973
Leonora,1980,4029,Leonora,2009,6003,1974
Lavelle,1980,4424,Lavelle,2009,6401,1977
Ginger,1980,596,Ginger,2009,2574,1978
Baltazar,1980,2988,Baltazar,2009,4969,1981
Dequan,1980,3806,Dequan,2009,5795,1989
Latavia,1980,4986,Latavia,2009,6975,1989
Caesar,1980,2726,Caesar,2009,4718,1992
Octavia,1980,1376,Octavia,2009,3369,1993
Guy,1980,878,Guy,2009,2874,1996
Devaughn,1980,3599,Devaughn,2009,5598,1999
Robyn,1980,348,Robyn,2009,2348,2000
Michel,1980,1889,Michel,2009,3889,2000
Sheila,1980,415,Sheila,2009,2418,2003
Aime,1980,4003,Aime,2009,6006,2003
Glenn,1980,442,Glenn,2009,2447,2005
Jena,1980,1447,Jena,2009,3453,2006
Brigid,1980,2289,Brigid,2009,4295,2006
Gianfranco,1980,5279,Gianfranco,2009,7285,2006
Avelino,1980,5701,Avelino,2009,7709,2008
Lani,1980,1819,Lani,2009,3830,2011
Otis,1980,1074,Otis,2009,3092,2018
Hans,1980,1400,Hans,2009,3421,2021
Terell,1980,3869,Terell,2009,5890,2021
Keturah,1980,3426,Keturah,2009,5448,2022
Marjorie,1980,1013,Marjorie,2009,3036,2023
Dave,1980,1705,Dave,2009,3728,2023
Cornell,1980,1709,Cornell,2009,3732,2023
Manuela,1980,2264,Manuela,2009,4288,2024
Casandra,1980,1225,Casandra,2009,3251,2026
Luigi,1980,2586,Luigi,2009,4612,2026
Jeff,1980,738,Jeff,2009,2767,2029
Willy,1980,3572,Willy,2009,5604,2032
Pia,1980,2865,Pia,2009,4901,2036
Melinda,1980,187,Melinda,2009,2226,2039
Marielena,1980,4513,Marielena,2009,6555,2042
Brandi,1980,130,Brandi,2009,2173,2043
Zinnia,1980,4545,Zinnia,2009,6588,2043
Konstantinos,1980,3043,Konstantinos,2009,5087,2044
Vidal,1980,2309,Vidal,2009,4354,2045
Jenifer,1980,613,Jenifer,2009,2663,2050
Jesenia,1980,1898,Jesenia,2009,3950,2052
Mendy,1980,2836,Mendy,2009,4889,2053
Basil,1980,3529,Basil,2009,5583,2054
Mele,1980,3961,Mele,2009,6016,2055
Darla,1980,1060,Darla,2009,3116,2056
Lisette,1980,1423,Lisette,2009,3480,2057
Arin,1980,3952,Arin,2009,6013,2061
Valencia,1980,1418,Valencia,2009,3486,2068
Edna,1980,1143,Edna,2009,3217,2074
Soledad,1980,2626,Soledad,2009,4700,2074
Avelina,1980,5536,Avelina,2009,7611,2075
Chassidy,1980,2584,Chassidy,2009,4660,2076
Ruchel,1980,5237,Ruchel,2009,7314,2077
Candice,1980,202,Candice,2009,2281,2079
Lavon,1980,2204,Lavon,2009,4291,2087
Jaret,1980,5470,Jaret,2009,7558,2088
Demario,1980,1438,Demario,2009,3534,2096
Dan,1980,1008,Dan,2009,3113,2105
Tamyra,1980,4918,Tamyra,2009,7025,2107
Yolanda,1980,312,Yolanda,2009,2423,2111
Roel,1980,1881,Roel,2009,3995,2114
Brianne,1980,457,Brianne,2009,2573,2116
Flavio,1980,2990,Flavio,2009,5106,2116
Chaney,1980,5373,Chaney,2009,7499,2126
Elio,1980,3085,Elio,2009,5215,2130
Malinda,1980,945,Malinda,2009,3082,2137
Leann,1980,790,Leann,2009,2932,2142
Tremaine,1980,1734,Tremaine,2009,3876,2142
Eugenio,1980,2461,Eugenio,2009,4609,2148
Shant,1980,3692,Shant,2009,5842,2150
Maegan,1980,1927,Maegan,2009,4082,2155
Maira,1980,1489,Maira,2009,3648,2159
Venus,1980,1439,Venus,2009,3601,2162
Margaux,1980,3542,Margaux,2009,5708,2166
Jacques,1980,1697,Jacques,2009,3866,2169
Kofi,1980,5286,Kofi,2009,7457,2171
Montez,1980,3457,Montez,2009,5631,2174
Stacey,1980,142,Stacey,2009,2318,2176
Servando,1980,3247,Servando,2009,5424,2177
Nichole,1980,207,Nichole,2009,2390,2183
Lonnie,1980,634,Lonnie,2009,2819,2185
Levon,1980,2789,Levon,2009,4974,2185
Freddie,1980,793,Freddie,2009,2979,2186
Zenaida,1980,3199,Zenaida,2009,5385,2186
Annamaria,1980,3104,Annamaria,2009,5304,2200
Donnie,1980,742,Donnie,2009,2943,2201
Ubaldo,1980,3123,Ubaldo,2009,5329,2206
Betty,1980,653,Betty,2009,2864,2211
Eliud,1980,3842,Eliud,2009,6053,2211
Roque,1980,2998,Roque,2009,5211,2213
Griselda,1980,1142,Griselda,2009,3357,2215
Olga,1980,998,Olga,2009,3215,2217
Jovana,1980,2804,Jovana,2009,5021,2217
Lester,1980,829,Lester,2009,3051,2222
Raj,1980,4734,Raj,2009,6956,2222
Ilana,1980,2006,Ilana,2009,4229,2223
Johnnie,1980,780,Johnnie,2009,3006,2226
Marisela,1980,1184,Marisela,2009,3410,2226
Jessika,1980,2543,Jessika,2009,4769,2226
Boris,1980,3527,Boris,2009,5757,2230
Roxie,1980,3755,Roxie,2009,5988,2233
Ebony,1980,336,Ebony,2009,2575,2239
Darcy,1980,831,Darcy,2009,3071,2240
Danniel,1980,3967,Danniel,2009,6209,2242
Liza,1980,846,Liza,2009,3089,2243
Jannet,1980,3732,Jannet,2009,5976,2244
Don,1980,697,Don,2009,2942,2245
Haydee,1980,2513,Haydee,2009,4759,2246
Rhiana,1980,4660,Rhiana,2009,6907,2247
Brant,1980,1513,Brant,2009,3763,2250
Erasmo,1980,2356,Erasmo,2009,4608,2252
Caron,1980,5539,Caron,2009,7791,2252
Edmund,1980,1181,Edmund,2009,3434,2253
Tracy,1980,110,Tracy,2009,2366,2256
Barry,1980,369,Barry,2009,2625,2256
Randi,1980,618,Randi,2009,2877,2259
Dinah,1980,2773,Dinah,2009,5033,2260
Courtland,1980,4576,Courtland,2009,6839,2263
Clyde,1980,923,Clyde,2009,3187,2264
Amer,1980,5056,Amer,2009,7323,2267
Jacklynn,1980,4617,Jacklynn,2009,6885,2268
Leanne,1980,643,Leanne,2009,2917,2274
Basilio,1980,3973,Basilio,2009,6247,2274
Bulmaro,1980,5704,Bulmaro,2009,7978,2274
Aleesha,1980,5525,Aleesha,2009,7800,2275
Wilfredo,1980,1261,Wilfredo,2009,3537,2276
Earl,1980,522,Earl,2009,2799,2277
Frieda,1980,3395,Frieda,2009,5673,2278
Annel,1980,5533,Annel,2009,7811,2278
Yanet,1980,3669,Yanet,2009,5950,2281
Octavius,1980,2832,Octavius,2009,5114,2282
Fermin,1980,2238,Fermin,2009,4524,2286
Ronit,1980,4304,Ronit,2009,6590,2286
Makoto,1980,5750,Makoto,2009,8040,2290
Dora,1980,1072,Dora,2009,3363,2291
Bernice,1980,1532,Bernice,2009,3823,2291
Clifford,1980,423,Clifford,2009,2715,2292
Trisha,1980,315,Trisha,2009,2608,2293
Breann,1980,2109,Breann,2009,4404,2295
Theodora,1980,3263,Theodora,2009,5558,2295
Gabrial,1980,3977,Gabrial,2009,6276,2299
Arianne,1980,2017,Arianne,2009,4317,2300
Beverly,1980,631,Beverly,2009,2936,2305
Brook,1980,863,Brook,2009,3175,2312
Josephina,1980,4238,Josephina,2009,6550,2312
Rick,1980,864,Rick,2009,3183,2319
Darrin,1980,1139,Darrin,2009,3458,2319
Anel,1980,2605,Anel,2009,4924,2319
Fanta,1980,4381,Fanta,2009,6705,2324
Cedrick,1980,1301,Cedrick,2009,3627,2326
Ravi,1980,2997,Ravi,2009,5326,2329
Gabino,1980,3246,Gabino,2009,5575,2329
Carlton,1980,849,Carlton,2009,3180,2331
Yanira,1980,1978,Yanira,2009,4309,2331
Robinson,1980,4317,Robinson,2009,6653,2336
Opal,1980,2897,Opal,2009,5234,2337
Agnes,1980,2569,Agnes,2009,4907,2338
Melony,1980,2351,Melony,2009,4697,2346
Monet,1980,2677,Monet,2009,5025,2348
Norma,1980,606,Norma,2009,2955,2349
Emiko,1980,4498,Emiko,2009,6847,2349
Kurtis,1980,912,Kurtis,2009,3265,2353
Adrianne,1980,868,Adrianne,2009,3224,2356
Eloy,1980,1916,Eloy,2009,4279,2363
Nicklaus,1980,2705,Nicklaus,2009,5070,2365
Marlo,1980,2034,Marlo,2009,4401,2367
Horacio,1980,1904,Horacio,2009,4274,2370
Ilene,1980,2767,Ilene,2009,5141,2374
Geoffrey,1980,414,Geoffrey,2009,2789,2375
Alba,1980,2205,Alba,2009,4580,2375
Ashia,1980,5119,Ashia,2009,7495,2376
Sirena,1980,3109,Sirena,2009,5487,2378
Krysten,1980,3879,Krysten,2009,6261,2382
Melisa,1980,724,Melisa,2009,3109,2385
Daryl,1980,594,Daryl,2009,2981,2387
Evette,1980,2549,Evette,2009,4936,2387
Myron,1980,1035,Myron,2009,3425,2390
Joanne,1980,638,Joanne,2009,3031,2393
Nykia,1980,4303,Nykia,2009,6699,2396
Rasheed,1980,2025,Rasheed,2009,4422,2397
Kent,1980,784,Kent,2009,3182,2398
Michell,1980,1988,Michell,2009,4393,2405
Daren,1980,1540,Daren,2009,3955,2415
Meg,1980,5165,Meg,2009,7580,2415
Jeanette,1980,482,Jeanette,2009,2898,2416
Tarik,1980,2314,Tarik,2009,4731,2417
Duane,1980,623,Duane,2009,3041,2418
Mona,1980,1674,Mona,2009,4092,2418
Holley,1980,2364,Holley,2009,4786,2422
Lloyd,1980,719,Lloyd,2009,3144,2425
Angelia,1980,1046,Angelia,2009,3472,2426
Felicia,1980,322,Felicia,2009,2751,2429
Ramona,1980,1052,Ramona,2009,3481,2429
Clifton,1980,575,Clifton,2009,3013,2438
Fred,1980,700,Fred,2009,3140,2440
Eliazar,1980,4185,Eliazar,2009,6625,2440
Sonja,1980,902,Sonja,2009,3354,2452
Edgardo,1980,1854,Edgardo,2009,4306,2452
Aide,1980,2486,Aide,2009,4938,2452
Tai,1980,1586,Tai,2009,4050,2464
Mirian,1980,3489,Mirian,2009,5956,2467
Sharlene,1980,2545,Sharlene,2009,5014,2469
Rickey,1980,708,Rickey,2009,3179,2471
Annemarie,1980,1496,Annemarie,2009,3970,2474
Jarom,1980,3414,Jarom,2009,5895,2481
Artemio,1980,2730,Artemio,2009,5220,2490
Augustin,1980,2822,Augustin,2009,5316,2494
Shanell,1980,1768,Shanell,2009,4268,2500
Susie,1980,1340,Susie,2009,3841,2501
Fareed,1980,3894,Fareed,2009,6396,2502
Melodie,1980,1838,Melodie,2009,4341,2503
Jamaal,1980,836,Jamaal,2009,3340,2504
Josette,1980,3221,Josette,2009,5725,2504
Monte,1980,1852,Monte,2009,4357,2505
Leeann,1980,1145,Leeann,2009,3651,2506
Abran,1980,3248,Abran,2009,5756,2508
Herman,1980,926,Herman,2009,3436,2510
Franklyn,1980,3904,Franklyn,2009,6421,2517
Quincey,1980,4435,Quincey,2009,6955,2520
Vito,1980,1763,Vito,2009,4285,2522
Mandy,1980,254,Mandy,2009,2777,2523
Marlena,1980,1068,Marlena,2009,3592,2524
Celso,1980,5455,Celso,2009,7979,2524
Homero,1980,2219,Homero,2009,4744,2525
Enoc,1980,3702,Enoc,2009,6228,2526
Hilda,1980,1179,Hilda,2009,3706,2527
Brynne,1980,4194,Brynne,2009,6726,2532
Jannelle,1980,4620,Jannelle,2009,7154,2534
Ivon,1980,4616,Ivon,2009,7152,2536
Monika,1980,1294,Monika,2009,3832,2538
Nima,1980,4732,Nima,2009,7271,2539
Bonnie,1980,320,Bonnie,2009,2863,2543
Lisandra,1980,3198,Lisandra,2009,5746,2548
Ida,1980,1324,Ida,2009,3875,2551
Melyssa,1980,3741,Melyssa,2009,6299,2558
Justina,1980,1527,Justina,2009,4087,2560
Jayme,1980,762,Jayme,2009,3323,2561
Dayna,1980,1009,Dayna,2009,3570,2561
Gladis,1980,3370,Gladis,2009,5932,2562
Charlene,1980,463,Charlene,2009,3026,2563
Fanny,1980,2712,Fanny,2009,5278,2566
Antoinette,1980,721,Antoinette,2009,3289,2568
Arnulfo,1980,1784,Arnulfo,2009,4359,2575
Domenico,1980,2475,Domenico,2009,5061,2586
Gavino,1980,3776,Gavino,2009,6370,2594
Jr,1980,4965,Jr,2009,7560,2595
Marlin,1980,1839,Marlin,2009,4437,2598
Alisia,1980,2686,Alisia,2009,5285,2599
Jarett,1980,2467,Jarett,2009,5067,2600
Juanita,1980,570,Juanita,2009,3172,2602
Kurt,1980,388,Kurt,2009,2991,2603
Evangelia,1980,4823,Evangelia,2009,7430,2607
Kristine,1980,361,Kristine,2009,2969,2608
Irma,1980,995,Irma,2009,3604,2609
Lorraine,1980,791,Lorraine,2009,3402,2611
Reymundo,1980,2105,Reymundo,2009,4720,2615
Clarisa,1980,2903,Clarisa,2009,5521,2618
Neomi,1980,3559,Neomi,2009,6178,2619
Darell,1980,3827,Darell,2009,6450,2623
Deyanira,1980,3477,Deyanira,2009,6104,2627
Bibi,1980,5190,Bibi,2009,7824,2634
Adalberto,1980,1965,Adalberto,2009,4601,2636
Corina,1980,966,Corina,2009,3607,2641
Chioma,1980,5192,Chioma,2009,7833,2641
Geremy,1980,5465,Geremy,2009,8106,2641
Rosemarie,1980,1182,Rosemarie,2009,3824,2642
Krysta,1980,2548,Krysta,2009,5191,2643
Jeniffer,1980,2648,Jeniffer,2009,5292,2644
Mindy,1980,252,Mindy,2009,2900,2648
Abelardo,1980,2451,Abelardo,2009,5099,2648
Stefanie,1980,379,Stefanie,2009,3032,2653
Derrell,1980,3207,Derrell,2009,5865,2658
Neal,1980,712,Neal,2009,3371,2659
Jimmie,1980,777,Jimmie,2009,3437,2660
Amado,1980,2728,Amado,2009,5393,2665
Francisca,1980,1484,Francisca,2009,4154,2670
Rosendo,1980,2137,Rosendo,2009,4809,2672
Janette,1980,1083,Janette,2009,3770,2687
Chauncey,1980,1596,Chauncey,2009,4290,2694
Trinidad,1980,1937,Trinidad,2009,4631,2694
Rachelle,1980,500,Rachelle,2009,3196,2696
Rana,1980,2857,Rana,2009,5556,2699
Clair,1980,4180,Clair,2009,6880,2700
Faustino,1980,2697,Faustino,2009,5400,2703
Hilario,1980,2523,Hilario,2009,5229,2706
Aric,1980,1575,Aric,2009,4283,2708
Josefina,1980,1362,Josefina,2009,4076,2714
Diane,1980,393,Diane,2009,3111,2718
Jessi,1980,1761,Jessi,2009,4484,2723
Jeanpaul,1980,3696,Jeanpaul,2009,6426,2730
Margo,1980,1621,Margo,2009,4352,2731
Jolynn,1980,2302,Jolynn,2009,5034,2732
Jenelle,1980,1344,Jenelle,2009,4080,2736
Ina,1980,4904,Ina,2009,7640,2736
Carolynn,1980,3200,Carolynn,2009,5938,2738
Valentine,1980,2994,Valentine,2009,5737,2743
Louise,1980,1266,Louise,2009,4011,2745
Bradly,1980,1383,Bradly,2009,4130,2747
Sigifredo,1980,5779,Sigifredo,2009,8526,2747
Rena,1980,1082,Rena,2009,3831,2749
Gisela,1980,2267,Gisela,2009,5017,2750
Brannon,1980,1632,Brannon,2009,4384,2752
Lyle,1980,1202,Lyle,2009,3956,2754
Zeth,1980,5788,Zeth,2009,8542,2754
Linette,1980,3196,Linette,2009,5955,2759
Mildred,1980,1506,Mildred,2009,4267,2761
Demitrius,1980,4356,Demitrius,2009,7121,2765
Johndavid,1980,4964,Johndavid,2009,7730,2766
Judy,1980,741,Judy,2009,3510,2769
Baby,1980,4193,Baby,2009,6963,2770
Leopoldo,1980,1868,Leopoldo,2009,4639,2771
Janna,1980,946,Janna,2009,3722,2776
Edmond,1980,1500,Edmond,2009,4276,2776
Mirella,1980,2159,Mirella,2009,4944,2785
Brad,1980,247,Brad,2009,3040,2793
Vinay,1980,3985,Vinay,2009,6778,2793
Shelton,1980,1825,Shelton,2009,4620,2795
Betsaida,1980,4817,Betsaida,2009,7614,2797
Indira,1980,2691,Indira,2009,5489,2798
Kirk,1980,573,Kirk,2009,3374,2801
Matilde,1980,3493,Matilde,2009,6297,2804
Dionte,1980,3868,Dionte,2009,6673,2805
Althea,1980,2722,Althea,2009,5528,2806
Pietro,1980,3824,Pietro,2009,6630,2806
Shanelle,1980,1980,Shanelle,2009,4788,2808
Vernon,1980,626,Vernon,2009,3435,2809
Archie,1980,1467,Archie,2009,4281,2814
Taina,1980,3058,Taina,2009,5873,2815
Stefani,1980,1945,Stefani,2009,4765,2820
Lenin,1980,3410,Lenin,2009,6233,2823
Ivelisse,1980,3593,Ivelisse,2009,6417,2824
Jamila,1980,1260,Jamila,2009,4086,2826
Jamin,1980,2035,Jamin,2009,4864,2829
Elvira,1980,1555,Elvira,2009,4391,2836
Lori,1980,155,Lori,2009,2993,2838
Ikaika,1980,3432,Ikaika,2009,6271,2839
Christa,1980,485,Christa,2009,3325,2840
Macario,1980,2758,Macario,2009,5600,2842
Delvin,1980,1960,Delvin,2009,4812,2852
Elvia,1980,1641,Elvia,2009,4494,2853
Connie,1980,553,Connie,2009,3413,2860
Roni,1980,3491,Roni,2009,6352,2861
Samual,1980,2556,Samual,2009,5423,2867
Tuesday,1980,4040,Tuesday,2009,6916,2876
Kristal,1980,894,Kristal,2009,3773,2879
Marta,1980,1280,Marta,2009,4162,2882
Ioannis,1980,3905,Ioannis,2009,6794,2889
Frimet,1980,3815,Frimet,2009,6706,2891
Conan,1980,4047,Conan,2009,6939,2892
Richelle,1980,1444,Richelle,2009,4340,2896
Tiare,1980,3688,Tiare,2009,6586,2898
Rosamaria,1980,4010,Rosamaria,2009,6909,2899
Susannah,1980,2112,Susannah,2009,5012,2900
Doris,1980,1104,Doris,2009,4008,2904
Dara,1980,859,Dara,2009,3771,2912
Kimball,1980,4482,Kimball,2009,7401,2919
Yvonne,1980,433,Yvonne,2009,3358,2925
Elida,1980,2067,Elida,2009,4995,2928
Betzaida,1980,3044,Betzaida,2009,5973,2929
Christ,1980,5347,Christ,2009,8285,2938
Jeffry,1980,1415,Jeffry,2009,4364,2949
Rikki,1980,1639,Rikki,2009,4589,2950
Joann,1980,699,Joann,2009,3652,2953
Ashlie,1980,1617,Ashlie,2009,4571,2954
Jaison,1980,2660,Jaison,2009,5617,2957
Lizzette,1980,3017,Lizzette,2009,5982,2965
Julieann,1980,2964,Julieann,2009,5942,2978
Domingo,1980,1553,Domingo,2009,4532,2979
Marcial,1980,3244,Marcial,2009,6223,2979
Breanne,1980,1024,Breanne,2009,4005,2981
Kari,1980,310,Kari,2009,3298,2988
Clement,1980,3635,Clement,2009,6624,2989
Floyd,1980,850,Floyd,2009,3847,2997
Donnell,1980,1099,Donnell,2009,4099,3000
Kawan,1980,5179,Kawan,2009,8182,3003
Hollie,1980,689,Hollie,2009,3694,3005
Leonor,1980,2488,Leonor,2009,5496,3008
Glen,1980,688,Glen,2009,3698,3010
Rosalynn,1980,3546,Rosalynn,2009,6559,3013
Evans,1980,4751,Evans,2009,7765,3014
Stuart,1980,737,Stuart,2009,3752,3015
Nikole,1980,1485,Nikole,2009,4500,3015
Charlette,1980,3170,Charlette,2009,6186,3016
Demetrio,1980,3029,Demetrio,2009,6047,3018
Nicolle,1980,1791,Nicolle,2009,4831,3040
Beila,1980,5189,Beila,2009,8229,3040
Kaseem,1980,5178,Kaseem,2009,8221,3043
Kristofer,1980,1316,Kristofer,2009,4361,3045
Barbie,1980,2640,Barbie,2009,5685,3045
Pete,1980,1359,Pete,2009,4412,3053
Inez,1980,1840,Inez,2009,4899,3059
Rachell,1980,2650,Rachell,2009,5711,3061
Rashaun,1980,2432,Rashaun,2009,5502,3070
Deonta,1980,5058,Deonta,2009,8130,3072
Tim,1980,1640,Tim,2009,4719,3079
Darin,1980,842,Darin,2009,3922,3080
Shanti,1980,2867,Shanti,2009,5948,3081
Ron,1980,1110,Ron,2009,4194,3084
Christy,1980,167,Christy,2009,3253,3086
Tanisha,1980,600,Tanisha,2009,3687,3087
Rommel,1980,3970,Rommel,2009,7061,3091
Penny,1980,735,Penny,2009,3828,3093
Saeed,1980,3141,Saeed,2009,6235,3094
Keldrick,1980,5475,Keldrick,2009,8569,3094
Clemente,1980,2652,Clemente,2009,5759,3107
Ibn,1980,3357,Ibn,2009,6467,3110
Ami,1980,1227,Ami,2009,4339,3112
Cecil,1980,872,Cecil,2009,3989,3117
Norberto,1980,1861,Norberto,2009,4979,3118
Salena,1980,2516,Salena,2009,5636,3120
Rosalina,1980,3185,Rosalina,2009,6306,3121
Nikolaus,1980,2993,Nikolaus,2009,6122,3129
Yahira,1980,4403,Yahira,2009,7534,3131
Florencia,1980,4500,Florencia,2009,7634,3134
Estee,1980,5565,Estee,2009,8703,3138
Corrina,1980,2002,Corrina,2009,5144,3142
Chassity,1980,3643,Chassity,2009,6789,3146
Miki,1980,4521,Miki,2009,7671,3150
Valarie,1980,1079,Valarie,2009,4231,3152
Enos,1980,4323,Enos,2009,7482,3159
Luther,1980,1369,Luther,2009,4537,3168
Brandan,1980,2428,Brandan,2009,5596,3168
Eamonn,1980,5716,Eamonn,2009,8885,3169
Britta,1980,2902,Britta,2009,6080,3178
Agustina,1980,4578,Agustina,2009,7758,3180
Rifka,1980,3897,Rifka,2009,7084,3187
Garren,1980,5729,Garren,2009,8917,3188
Kellie,1980,402,Kellie,2009,3594,3192
Laurence,1980,1647,Laurence,2009,4848,3201
May,1980,1754,May,2009,4957,3203
Bernadette,1980,877,Bernadette,2009,4085,3208
Vi,1980,4744,Vi,2009,7952,3208
Tito,1980,2379,Tito,2009,5595,3216
Lauro,1980,2827,Lauro,2009,6043,3216
Aidee,1980,4580,Aidee,2009,7796,3216
Angella,1980,2480,Angella,2009,5707,3227
Leeroy,1980,4339,Leeroy,2009,7566,3227
Lois,1980,1704,Lois,2009,4937,3233
Michele,1980,240,Michele,2009,3475,3235
Kory,1980,1045,Kory,2009,4280,3235
Minh,1980,3125,Minh,2009,6361,3236
Sari,1980,3237,Sari,2009,6476,3239
Bret,1980,881,Bret,2009,4123,3242
Ofelia,1980,1936,Ofelia,2009,5180,3244
Marietta,1980,4093,Marietta,2009,7343,3250
Kerstin,1980,5584,Kerstin,2009,8835,3251
Jonmichael,1980,3580,Jonmichael,2009,6832,3252
Tammy,1980,195,Tammy,2009,3448,3253
Jayne,1980,1683,Jayne,2009,4940,3257
Sachin,1980,3359,Sachin,2009,6616,3257
Shalini,1980,4671,Shalini,2009,7937,3266
Demond,1980,1390,Demond,2009,4658,3268
Talitha,1980,2690,Talitha,2009,5959,3269
Raeanna,1980,4657,Raeanna,2009,7926,3269
Janel,1980,903,Janel,2009,4173,3270
Jahmal,1980,3712,Jahmal,2009,6985,3273
Deana,1980,962,Deana,2009,4236,3274
Brigitte,1980,1994,Brigitte,2009,5275,3281
Maranda,1980,919,Maranda,2009,4204,3285
Gennaro,1980,4169,Gennaro,2009,7454,3285
Angelita,1980,1420,Angelita,2009,4708,3288
Suzanna,1980,1747,Suzanna,2009,5035,3288
Stephani,1980,2251,Stephani,2009,5544,3293
Imelda,1980,1628,Imelda,2009,4922,3294
Ariane,1980,2004,Ariane,2009,5299,3295
Sacha,1980,2299,Sacha,2009,5594,3295
Kawika,1980,2927,Kawika,2009,6222,3295
Janine,1980,778,Janine,2009,4074,3296
Jed,1980,1441,Jed,2009,4753,3312
Dawn,1980,137,Dawn,2009,3450,3313
Andria,1980,1023,Andria,2009,4343,3320
Kristy,1980,158,Kristy,2009,3482,3324
Salina,1980,1457,Salina,2009,4781,3324
Shani,1980,2045,Shani,2009,5376,3331
Wally,1980,5491,Wally,2009,8823,3332
Passion,1980,5126,Passion,2009,8459,3333
Lacee,1980,4182,Lacee,2009,7521,3339
Derik,1980,1511,Derik,2009,4855,3344
Elva,1980,2144,Elva,2009,5488,3344
Arnoldo,1980,2310,Arnoldo,2009,5658,3348
Mirna,1980,1809,Mirna,2009,5160,3351
Lorenza,1980,3227,Lorenza,2009,6580,3353
Minerva,1980,1912,Minerva,2009,5283,3371
Shakir,1980,5307,Shakir,2009,8682,3375
Forest,1980,2378,Forest,2009,5754,3376
Herbert,1980,716,Herbert,2009,4095,3379
Naftoli,1980,5291,Naftoli,2009,8674,3383
Kamuela,1980,4760,Kamuela,2009,8146,3386
Jenise,1980,2955,Jenise,2009,6344,3389
Sora,1980,4306,Sora,2009,7696,3390
Tomasz,1980,4777,Tomasz,2009,8168,3391
Juliann,1980,2519,Juliann,2009,5915,3396
Kiyana,1980,5038,Kiyana,2009,8436,3398
Hilary,1980,605,Hilary,2009,4004,3399
Mickey,1980,1311,Mickey,2009,4716,3405
Corrine,1980,1306,Corrine,2009,4712,3406
Freida,1980,4828,Freida,2009,8238,3410
Elton,1980,1698,Elton,2009,5109,3411
An,1980,3727,An,2009,7141,3414
Rebecka,1980,3490,Rebecka,2009,6906,3416
Calogero,1980,4865,Calogero,2009,8284,3419
Janiece,1980,4442,Janiece,2009,7867,3425
Lashawn,1980,1304,Lashawn,2009,4730,3426
Filiberto,1980,2621,Filiberto,2009,6048,3427
Raelene,1980,4257,Raelene,2009,7684,3427
Maida,1980,4007,Maida,2009,7435,3428
Amit,1980,1967,Amit,2009,5401,3434
Kacee,1980,5578,Kacee,2009,9020,3442
Loryn,1980,5610,Loryn,2009,9052,3442
Sabas,1980,5773,Sabas,2009,9221,3448
Kimberley,1980,720,Kimberley,2009,4172,3452
Lavell,1980,2992,Lavell,2009,6444,3452
Miriah,1980,5622,Miriah,2009,9076,3454
Deena,1980,1582,Deena,2009,5038,3456
Lucina,1980,4207,Lucina,2009,7663,3456
Chester,1980,988,Chester,2009,4446,3458
Elicia,1980,2071,Elicia,2009,5529,3458
Dedrick,1980,1657,Dedrick,2009,5123,3466
Wallace,1980,1190,Wallace,2009,4657,3467
Deandra,1980,2315,Deandra,2009,5789,3474
Jarod,1980,936,Jarod,2009,4419,3483
Sylvester,1980,1331,Sylvester,2009,4816,3485
Alesia,1980,3998,Alesia,2009,7490,3492
Collette,1980,3386,Collette,2009,6881,3495
Pascual,1980,3117,Pascual,2009,6615,3498
Vinh,1980,3565,Vinh,2009,7066,3501
Alika,1980,3789,Alika,2009,7291,3502
Pincus,1980,5299,Pincus,2009,8811,3512
Elisabet,1980,2803,Elisabet,2009,6318,3515
Anselmo,1980,2877,Anselmo,2009,6395,3518
Anh,1980,2416,Anh,2009,5936,3520
Dianne,1980,1660,Dianne,2009,5183,3523
Dontez,1980,5325,Dontez,2009,8849,3524
Dusty,1980,608,Dusty,2009,4133,3525
Nisha,1980,2639,Nisha,2009,6165,3526
Tri,1980,4223,Tri,2009,7752,3529
Jovon,1980,2498,Jovon,2009,6028,3530
Amie,1980,495,Amie,2009,4030,3535
Hanif,1980,5350,Hanif,2009,8886,3536
Antione,1980,1579,Antione,2009,5116,3537
Paulette,1980,1609,Paulette,2009,5146,3537
Gene,1980,823,Gene,2009,4368,3545
Cori,1980,1044,Cori,2009,4591,3547
China,1980,2899,China,2009,6446,3547
Margarito,1980,2507,Margarito,2009,6055,3548
Racheal,1980,1112,Racheal,2009,4661,3549
Reggie,1980,1250,Reggie,2009,4804,3554
Kerry,1980,374,Kerry,2009,3933,3559
Misty,1980,107,Misty,2009,3674,3567
Tal,1980,5249,Tal,2009,8821,3572
Sameera,1980,5168,Sameera,2009,8742,3574
Rodrick,1980,1247,Rodrick,2009,4822,3575
Eloisa,1980,2439,Eloisa,2009,6014,3575
Wendell,1980,1042,Wendell,2009,4623,3581
Corinna,1980,2039,Corinna,2009,5623,3584
Joycelyn,1980,2575,Joycelyn,2009,6159,3584
Denny,1980,1802,Denny,2009,5399,3597
Kanani,1980,4281,Kanani,2009,7879,3598
Kassie,1980,2589,Kassie,2009,6189,3600
Marianne,1980,883,Marianne,2009,4486,3603
Janis,1980,1753,Janis,2009,5359,3606
Cathy,1980,722,Cathy,2009,4333,3611
Kimberli,1980,2965,Kimberli,2009,6579,3614
Lizett,1980,3538,Lizett,2009,7162,3624
Murad,1980,5180,Murad,2009,8804,3624
Jennie,1980,535,Jennie,2009,4163,3628
Lanna,1980,5413,Lanna,2009,9043,3630
Loretta,1980,873,Loretta,2009,4507,3634
Feliciano,1980,2991,Feliciano,2009,6627,3636
Rochelle,1980,591,Rochelle,2009,4230,3639
Danyelle,1980,1740,Danyelle,2009,5382,3642
Ronell,1980,4421,Ronell,2009,8064,3643
Nicky,1980,2089,Nicky,2009,5733,3644
Kimberlee,1980,943,Kimberlee,2009,4594,3651
Florence,1980,1832,Florence,2009,5485,3653
Nam,1980,3405,Nam,2009,7058,3653
Renatta,1980,3872,Renatta,2009,7530,3658
Consuelo,1980,1473,Consuelo,2009,5150,3677
Bethanie,1980,2474,Bethanie,2009,6152,3678
Suzette,1980,1853,Suzette,2009,5535,3682
Rahman,1980,4375,Rahman,2009,8057,3682
Gildardo,1980,3241,Gildardo,2009,6924,3683
Suzy,1980,4012,Suzy,2009,7698,3686
Shelly,1980,353,Shelly,2009,4043,3690
Angelic,1980,2298,Angelic,2009,5997,3699
Nathon,1980,5507,Nathon,2009,9208,3701
Jarrod,1980,437,Jarrod,2009,4139,3702
Jamail,1980,5469,Jamail,2009,9177,3708
Tyjuan,1980,3587,Tyjuan,2009,7296,3709
Joesph,1980,1277,Joesph,2009,4988,3711
Terra,1980,686,Terra,2009,4398,3712
Dimitrios,1980,2560,Dimitrios,2009,6275,3715
Zarina,1980,4860,Zarina,2009,8575,3715
Anthoney,1980,3987,Anthoney,2009,7707,3720
Christie,1980,446,Christie,2009,4176,3730
Glenda,1980,1020,Glenda,2009,4757,3737
Dionna,1980,2327,Dionna,2009,6065,3738
Vasilios,1980,2939,Vasilios,2009,6678,3739
Tory,1980,1587,Tory,2009,5342,3755
Zoila,1980,3482,Zoila,2009,7237,3755
Jodi,1980,323,Jodi,2009,4088,3765
Pauline,1980,1135,Pauline,2009,4900,3765
Ara,1980,4045,Ara,2009,7812,3767
Aleen,1980,5524,Aleen,2009,9293,3769
Froilan,1980,4218,Froilan,2009,7999,3781
Zipporah,1980,4861,Zipporah,2009,8649,3788
Fransisco,1980,2426,Fransisco,2009,6220,3794
Cristel,1980,5553,Cristel,2009,9349,3796
Tavon,1980,2258,Tavon,2009,6057,3799
Teddy,1980,1183,Teddy,2009,4984,3801
Sulema,1980,3110,Sulema,2009,6914,3804
Carnell,1980,5346,Carnell,2009,9155,3809
Nicola,1980,2018,Nicola,2009,5834,3816
Keyona,1980,5213,Keyona,2009,9030,3817
Bertha,1980,1333,Bertha,2009,5152,3819
Joleen,1980,1652,Joleen,2009,5476,3824
Ruthann,1980,4915,Ruthann,2009,8740,3825
Jaye,1980,5574,Jaye,2009,9402,3828
Cortney,1980,728,Cortney,2009,4558,3830
Lissette,1980,1443,Lissette,2009,5273,3830
Marla,1980,874,Marla,2009,4707,3833
Meaghan,1980,987,Meaghan,2009,4829,3842
Kimi,1980,5590,Kimi,2009,9432,3842
Grisel,1980,3793,Grisel,2009,7636,3843
Kandice,1980,1320,Kandice,2009,5167,3847
Baldomero,1980,3693,Baldomero,2009,7540,3847
Debra,1980,339,Debra,2009,4188,3849
Nyree,1980,5232,Nyree,2009,9086,3854
Anwar,1980,2618,Anwar,2009,6482,3864
Tavares,1980,1566,Tavares,2009,5431,3865
Michela,1980,4388,Michela,2009,8255,3867
Amada,1980,3932,Amada,2009,7803,3871
Thy,1980,5676,Thy,2009,9547,3871
Jenni,1980,1668,Jenni,2009,5540,3872
Vincente,1980,3407,Vincente,2009,7280,3873
Suzie,1980,5665,Suzie,2009,9538,3873
Alvino,1980,5694,Alvino,2009,9573,3879
Jeremie,1980,1341,Jeremie,2009,5232,3891
Monty,1980,2165,Monty,2009,6056,3891
Faviola,1980,2263,Faviola,2009,6156,3893
Vannessa,1980,2968,Vannessa,2009,6861,3893
Wilbert,1980,1419,Wilbert,2009,5320,3901
Cleveland,1980,1597,Cleveland,2009,5500,3903
Saleem,1980,2198,Saleem,2009,6101,3903
Denae,1980,3722,Denae,2009,7626,3904
Jawan,1980,4290,Jawan,2009,8194,3904
Lynda,1980,1031,Lynda,2009,4942,3911
Kenrick,1980,4882,Kenrick,2009,8794,3912
Kwabena,1980,4883,Kwabena,2009,8795,3912
Bernie,1980,4050,Bernie,2009,7976,3926
Claude,1980,1152,Claude,2009,5080,3928
Jelissa,1980,4159,Jelissa,2009,8087,3928
Sunshine,1980,1241,Sunshine,2009,5179,3938
Therese,1980,1590,Therese,2009,5531,3941
Esequiel,1980,2653,Esequiel,2009,6598,3945
Frantz,1980,3821,Frantz,2009,7766,3945
Karin,1980,1005,Karin,2009,4952,3947
Shamel,1980,2851,Shamel,2009,6798,3947
Robbie,1980,876,Robbie,2009,4828,3952
Ronnell,1980,3525,Ronnell,2009,7477,3952
Silvano,1980,4573,Silvano,2009,8527,3954
Racquel,1980,1857,Racquel,2009,5816,3959
Zahava,1980,4310,Zahava,2009,8273,3963
Chanell,1980,2672,Chanell,2009,6637,3965
Blas,1980,3412,Blas,2009,7378,3966
Demetria,1980,1115,Demetria,2009,5082,3967
Cathryn,1980,1822,Cathryn,2009,5790,3968
Clint,1980,394,Clint,2009,4363,3969
Juvenal,1980,3761,Juvenal,2009,7733,3972
Zakee,1980,4376,Zakee,2009,8360,3984
Keoki,1980,3790,Keoki,2009,7780,3990
Rahmel,1980,4315,Rahmel,2009,8306,3991
Marysol,1980,3218,Marysol,2009,7218,4000
Lanae,1980,4244,Lanae,2009,8248,4004
Amador,1980,2615,Amador,2009,6620,4005
Torie,1980,5097,Torie,2009,9107,4010
Marcia,1980,753,Marcia,2009,4777,4024
Kandace,1980,1805,Kandace,2009,5831,4026
Eladio,1980,3513,Eladio,2009,7548,4035
Sherry,1980,366,Sherry,2009,4403,4037
Shantel,1980,1322,Shantel,2009,5366,4044
Rasheem,1980,2675,Rasheem,2009,6725,4050
Deric,1980,1986,Deric,2009,6040,4054
Toddrick,1980,4475,Toddrick,2009,8530,4055
Bao,1980,5537,Bao,2009,9594,4057
Kahealani,1980,4071,Kahealani,2009,8140,4069
Ilona,1980,5202,Ilona,2009,9272,4070
Chanie,1980,4155,Chanie,2009,8231,4076
Kelli,1980,243,Kelli,2009,4320,4077
Suzana,1980,3865,Suzana,2009,7946,4081
Karena,1980,2771,Karena,2009,6853,4082
Rueben,1980,2876,Rueben,2009,6958,4082
Rosita,1980,2248,Rosita,2009,6331,4083
Bridgett,1980,1003,Bridgett,2009,5095,4092
Willis,1980,1237,Willis,2009,5331,4094
Jill,1980,136,Jill,2009,4238,4102
Renato,1980,3025,Renato,2009,7129,4104
Rosio,1980,1842,Rosio,2009,5947,4105
Melonie,1980,1831,Melonie,2009,5944,4113
Merle,1980,3358,Merle,2009,7476,4118
Clarice,1980,2449,Clarice,2009,6569,4120
Che,1980,3120,Che,2009,7245,4125
Lynn,1980,441,Lynn,2009,4568,4127
Kirby,1980,2330,Kirby,2009,6459,4129
Zena,1980,2785,Zena,2009,6919,4134
Anand,1980,2794,Anand,2009,6930,4136
Athina,1980,5188,Athina,2009,9326,4138
Sarita,1980,1813,Sarita,2009,5958,4145
Rheagan,1980,4945,Rheagan,2009,9092,4147
Niki,1980,1406,Niki,2009,5554,4148
Marilu,1980,3016,Marilu,2009,7165,4149
Claribel,1980,3680,Claribel,2009,7834,4154
Siobhan,1980,1154,Siobhan,2009,5309,4155
Raudel,1980,3406,Raudel,2009,7567,4161
Jody,1980,362,Jody,2009,4529,4167
Nidia,1980,2134,Nidia,2009,6302,4168
Ena,1980,5197,Ena,2009,9368,4171
Cesilia,1980,3654,Cesilia,2009,7831,4177
Keisha,1980,529,Keisha,2009,4713,4184
Vita,1980,3508,Vita,2009,7701,4193
Lindy,1980,1165,Lindy,2009,5363,4198
Bernardino,1980,3511,Bernardino,2009,7711,4200
Julieanne,1980,3675,Julieanne,2009,7875,4200
Sheena,1980,1635,Sheena,2009,5836,4201
Gustav,1980,5733,Gustav,2009,9945,4212
Jacquelynn,1980,4200,Jacquelynn,2009,8415,4215
Zachry,1980,5020,Zachry,2009,9240,4220
Maisha,1980,2856,Maisha,2009,7080,4224
Danisha,1980,5556,Danisha,2009,9780,4224
Edwardo,1980,1611,Edwardo,2009,5838,4227
Takiya,1980,4398,Takiya,2009,8625,4227
Maureen,1980,533,Maureen,2009,4780,4247
Ramone,1980,4096,Ramone,2009,8343,4247
Sebastiano,1980,4062,Sebastiano,2009,8311,4249
Aquil,1980,4105,Aquil,2009,8355,4250
Jaimie,1980,1269,Jaimie,2009,5524,4255
Bob,1980,2239,Bob,2009,6499,4260
Verna,1980,4094,Verna,2009,8354,4260
Goldie,1980,2518,Goldie,2009,6785,4267
Rondell,1980,3907,Rondell,2009,8176,4269
Johnna,1980,1643,Johnna,2009,5914,4271
Paulino,1980,3777,Paulino,2009,8054,4277
Ted,1980,934,Ted,2009,5218,4284
Gil,1980,2312,Gil,2009,6601,4289
Starla,1980,1228,Starla,2009,5519,4291
Weldon,1980,3092,Weldon,2009,7397,4305
Portia,1980,1701,Portia,2009,6011,4310
Merissa,1980,4519,Merissa,2009,8837,4318
Francine,1980,1379,Francine,2009,5698,4319
Suzanne,1980,270,Suzanne,2009,4596,4326
Millicent,1980,3585,Millicent,2009,7912,4327
Matt,1980,1245,Matt,2009,5578,4333
Rosetta,1980,2405,Rosetta,2009,6739,4334
Kendric,1980,3053,Kendric,2009,7388,4335
Amando,1980,4139,Amando,2009,8477,4338
Huy,1980,2786,Huy,2009,7125,4339
Lenora,1980,2123,Lenora,2009,6486,4363
Rasheen,1980,2435,Rasheen,2009,6803,4368
Greg,1980,727,Greg,2009,5100,4373
Antjuan,1980,4770,Antjuan,2009,9144,4374
Roberta,1980,816,Roberta,2009,5198,4382
Kelby,1980,4130,Kelby,2009,8512,4382
Alphonso,1980,1850,Alphonso,2009,6236,4386
Sunnie,1980,3555,Sunnie,2009,7945,4390
Alfonzo,1980,2527,Alfonzo,2009,6920,4393
Torrance,1980,2245,Torrance,2009,6655,4410
Brigette,1980,1899,Brigette,2009,6316,4417
Nereyda,1980,3501,Nereyda,2009,7920,4419
Garett,1980,2240,Garett,2009,6666,4426
Medina,1980,4302,Medina,2009,8730,4428
Meranda,1980,2931,Meranda,2009,7369,4438
Cipriano,1980,4046,Cipriano,2009,8484,4438
Becky,1980,484,Becky,2009,4925,4441
Nerissa,1980,3236,Nerissa,2009,7681,4445
Dena,1980,754,Dena,2009,5204,4450
Christal,1980,1085,Christal,2009,5537,4452
Ernie,1980,1766,Ernie,2009,6219,4453
Stoney,1980,2942,Stoney,2009,7396,4454
Vilma,1980,3498,Vilma,2009,7954,4456
Alim,1980,4805,Alim,2009,9268,4463
Kevan,1980,3568,Kevan,2009,8032,4464
Maximino,1980,3581,Maximino,2009,8045,4464
Doreen,1980,1689,Doreen,2009,6154,4465
Sylvan,1980,4432,Sylvan,2009,8899,4467
Randell,1980,1907,Randell,2009,6376,4469
Deserae,1980,4495,Deserae,2009,8975,4480
Thelma,1980,1722,Thelma,2009,6206,4484
Karisa,1980,2718,Karisa,2009,7208,4490
Justen,1980,2116,Justen,2009,6608,4492
Benji,1980,5100,Benji,2009,9596,4496
Raylon,1980,5482,Raylon,2009,9985,4503
Tarek,1980,3570,Tarek,2009,8076,4506
Virgil,1980,1352,Virgil,2009,5859,4507
Eduard,1980,4270,Eduard,2009,8779,4509
Panagiotis,1980,2938,Panagiotis,2009,7465,4527
Hubert,1980,1544,Hubert,2009,6072,4528
Kandy,1980,2676,Kandy,2009,7207,4531
Marty,1980,1066,Marty,2009,5601,4535
Domenica,1980,2228,Domenica,2009,6783,4555
Lindsy,1980,3107,Lindsy,2009,7662,4555
Earnest,1980,1134,Earnest,2009,5691,4557
Stewart,1980,1199,Stewart,2009,5774,4575
Malika,1980,1979,Malika,2009,6554,4575
Tremayne,1980,2101,Tremayne,2009,6677,4576
Celena,1980,2565,Celena,2009,7145,4580
Alecia,1980,1038,Alecia,2009,5625,4587
Danah,1980,4763,Danah,2009,9351,4588
Hosea,1980,5060,Hosea,2009,9648,4588
Germain,1980,3413,Germain,2009,8002,4589
Joella,1980,4125,Joella,2009,8718,4593
Jeanne,1980,895,Jeanne,2009,5493,4598
Glory,1980,3794,Glory,2009,8403,4609
Renae,1980,1059,Renae,2009,5678,4619
Keya,1980,3259,Keya,2009,7884,4625
Sammie,1980,2032,Sammie,2009,6658,4626
Brodrick,1980,2733,Brodrick,2009,7379,4646
Maryanne,1980,2566,Maryanne,2009,7217,4651
Denice,1980,2489,Denice,2009,7147,4658
Shanel,1980,2779,Shanel,2009,7441,4662
Sommer,1980,1130,Sommer,2009,5793,4663
Angelle,1980,2384,Angelle,2009,7070,4686
Nadiyah,1980,3890,Nadiyah,2009,8586,4696
Jim,1980,1070,Jim,2009,5770,4700
Jeannette,1980,812,Jeannette,2009,5518,4706
Amparo,1980,3100,Amparo,2009,7807,4707
Keri,1980,496,Keri,2009,5205,4709
Mariann,1980,3739,Mariann,2009,8448,4709
Ai,1980,4579,Ai,2009,9288,4709
Marcelina,1980,2954,Marcelina,2009,7667,4713
Moana,1980,4759,Moana,2009,9480,4721
Kwame,1980,2846,Kwame,2009,7582,4736
Omero,1980,4471,Omero,2009,9212,4741
Dino,1980,2179,Dino,2009,6922,4743
Daryn,1980,4868,Daryn,2009,9613,4745
Sabino,1980,4978,Sabino,2009,9726,4748
Crista,1980,2066,Crista,2009,6815,4749
Wayland,1980,4477,Wayland,2009,9236,4759
Caren,1980,2423,Caren,2009,7191,4768
Torrey,1980,1859,Torrey,2009,6632,4773
Judd,1980,2061,Judd,2009,6841,4780
Andree,1980,4360,Andree,2009,9142,4782
Mayela,1980,3667,Mayela,2009,8451,4784
Tommie,1980,1268,Tommie,2009,6064,4796
Shilo,1980,2893,Shilo,2009,7693,4800
Laurie,1980,377,Laurie,2009,5197,4820
Randolph,1980,1036,Randolph,2009,5858,4822
Mimi,1980,2344,Mimi,2009,7167,4823
Bill,1980,1201,Bill,2009,6026,4825
Nickole,1980,2399,Nickole,2009,7225,4826
Lanita,1980,3341,Lanita,2009,8169,4828
Minna,1980,4650,Minna,2009,9479,4829
Davy,1980,4786,Davy,2009,9615,4829
Amiee,1980,2766,Amiee,2009,7598,4832
Torrence,1980,3287,Torrence,2009,8119,4832
Kareema,1980,3887,Kareema,2009,8720,4833
Cathleen,1980,1477,Cathleen,2009,6317,4840
Trina,1980,684,Trina,2009,5532,4848
Fidencio,1980,2699,Fidencio,2009,7550,4851
Buddy,1980,1733,Buddy,2009,6594,4861
Rustin,1980,2706,Rustin,2009,7568,4862
Antonino,1980,3902,Antonino,2009,8764,4862
Alesha,1980,1222,Alesha,2009,6095,4873
Taisha,1980,1760,Taisha,2009,6642,4882
Chantel,1980,1084,Chantel,2009,5968,4884
Kim,1980,646,Kim,2009,5542,4896
Antwane,1980,4919,Antwane,2009,9818,4899
Najah,1980,3344,Najah,2009,8260,4916
Jameel,1980,1864,Jameel,2009,6802,4938
Silvio,1980,4896,Silvio,2009,9838,4942
Shawna,1980,355,Shawna,2009,5308,4953
Roosevelt,1980,1274,Roosevelt,2009,6249,4975
Eriberto,1980,2723,Eriberto,2009,7718,4995
Jerald,1980,1403,Jerald,2009,6399,4996
Khalif,1980,3892,Khalif,2009,8889,4997
Bjorn,1980,2407,Bjorn,2009,7414,5007
Minnie,1980,2644,Minnie,2009,7672,5028
Sunni,1980,3438,Sunni,2009,8469,5031
Sherman,1980,1053,Sherman,2009,6085,5032
Dolores,1980,1114,Dolores,2009,6153,5039
Stacie,1980,435,Stacie,2009,5481,5046
Rosalba,1980,1799,Rosalba,2009,6856,5057
Shana,1980,512,Shana,2009,5570,5058
Delvon,1980,4554,Delvon,2009,9616,5062
Brieanna,1980,3315,Brieanna,2009,8385,5070
Errol,1980,1849,Errol,2009,6941,5092
Kathrine,1980,1460,Kathrine,2009,6553,5093
Cherry,1980,2050,Cherry,2009,7146,5096
Jeanine,1980,1040,Jeanine,2009,6138,5098
Alix,1980,4815,Alix,2009,9913,5098
Agatha,1980,4812,Agatha,2009,9911,5099
Kelley,1980,440,Kelley,2009,5549,5109
Jenice,1980,4298,Jenice,2009,9408,5110
Bennie,1980,1319,Bennie,2009,6435,5116
Carmelita,1980,2485,Carmelita,2009,7620,5135
Raymon,1980,2923,Raymon,2009,8058,5135
Robby,1980,1256,Robby,2009,6392,5136
Ciro,1980,4464,Ciro,2009,9604,5140
Kristi,1980,239,Kristi,2009,5383,5144
Leander,1980,3652,Leander,2009,8797,5145
Rheanna,1980,4659,Rheanna,2009,9809,5150
Neisha,1980,4653,Neisha,2009,9805,5152
Billie,1980,547,Billie,2009,5700,5153
Delfino,1980,2820,Delfino,2009,7987,5167
Bobbi,1980,649,Bobbi,2009,5826,5177
Carlene,1980,2631,Carlene,2009,7828,5197
Deandrea,1980,3165,Deandrea,2009,8364,5199
Cristy,1980,1136,Cristy,2009,6339,5203
Philippe,1980,3090,Philippe,2009,8305,5215
Marilynn,1980,4250,Marilynn,2009,9466,5216
Olaf,1980,4733,Olaf,2009,9950,5217
Dannie,1980,3626,Dannie,2009,8847,5221
Lisset,1980,3219,Lisset,2009,8443,5224
Kimberlie,1980,4204,Kimberlie,2009,9431,5227
Gaetano,1980,3057,Gaetano,2009,8293,5236
Jahaira,1980,3172,Jahaira,2009,8416,5244
Arron,1980,1507,Arron,2009,6755,5248
Kirstin,1980,1634,Kirstin,2009,6890,5256
Estrellita,1980,3730,Estrellita,2009,8987,5257
Nichelle,1980,1812,Nichelle,2009,7083,5271
Sharif,1980,2075,Sharif,2009,7347,5272
Edmundo,1980,2274,Edmundo,2009,7547,5273
Jaimee,1980,1876,Jaimee,2009,7153,5277
Nicol,1980,4211,Nicol,2009,9493,5282
Carlota,1980,4493,Carlota,2009,9778,5285
Shon,1980,3205,Shon,2009,8524,5319
Codi,1980,3644,Codi,2009,8967,5323
Jasen,1980,1616,Jasen,2009,6944,5328
Lanette,1980,2542,Lanette,2009,7887,5345
Jacinto,1980,3157,Jacinto,2009,8503,5346
Jarred,1980,1032,Jarred,2009,6389,5357
Porfirio,1980,2695,Porfirio,2009,8056,5361
Leigh,1980,429,Leigh,2009,5797,5368
Wilbur,1980,2381,Wilbur,2009,7754,5373
Jeron,1980,3807,Jeron,2009,9184,5377
Irwin,1980,4272,Irwin,2009,9650,5378
Jenae,1980,3325,Jenae,2009,8717,5392
Chadwick,1980,862,Chadwick,2009,6270,5408
Laquan,1980,3441,Laquan,2009,8852,5411
Cheryl,1980,236,Cheryl,2009,5677,5441
Kayce,1980,3561,Kayce,2009,9024,5463
Tamera,1980,1518,Tamera,2009,6982,5464
Larisa,1980,2966,Larisa,2009,8440,5474
Erich,1980,1150,Erich,2009,6626,5476
Tracey,1980,398,Tracey,2009,5876,5478
Kristie,1980,458,Kristie,2009,5943,5485
Rashon,1980,3173,Rashon,2009,8680,5507
Kristyn,1980,1329,Kristyn,2009,6838,5509
Chantelle,1980,1676,Chantelle,2009,7192,5516
Eugenia,1980,1486,Eugenia,2009,7023,5537
Markeith,1980,3651,Markeith,2009,9204,5553
Lemuel,1980,2658,Lemuel,2009,8222,5564
Karyn,1980,1159,Karyn,2009,6728,5569
Florentino,1980,2914,Florentino,2009,8491,5577
Lynnette,1980,1585,Lynnette,2009,7163,5578
Marylou,1980,3488,Marylou,2009,9069,5581
Kristoffer,1980,1677,Kristoffer,2009,7266,5589
Tyrice,1980,4359,Tyrice,2009,9955,5596
Nereida,1980,2321,Nereida,2009,7919,5598
Gricelda,1980,2247,Gricelda,2009,7856,5609
Darrel,1980,1373,Darrel,2009,6986,5613
Tenaya,1980,3930,Tenaya,2009,9544,5614
Christin,1980,774,Christin,2009,6406,5632
Odell,1980,4058,Odell,2009,9706,5648
Rickie,1980,1622,Rickie,2009,7276,5654
Lolita,1980,2233,Lolita,2009,7895,5662
Janett,1980,3318,Janett,2009,9006,5688
Darron,1980,2476,Darron,2009,8165,5689
Bradford,1980,673,Bradford,2009,6365,5692
Chasidy,1980,3268,Chasidy,2009,8963,5695
Amity,1980,3231,Amity,2009,8933,5702
Ramel,1980,2596,Ramel,2009,8308,5712
Teah,1980,3829,Teah,2009,9543,5714
Trish,1980,2223,Trish,2009,7950,5727
Charisse,1980,1867,Charisse,2009,7621,5754
Justo,1980,3422,Justo,2009,9190,5768
Helene,1980,2457,Helene,2009,8242,5785
Twyla,1980,3297,Twyla,2009,9110,5813
Charlton,1980,3081,Charlton,2009,8907,5826
Bobbie,1980,503,Bobbie,2009,6338,5835
Kacy,1980,1654,Kacy,2009,7514,5860
Alphonse,1980,3266,Alphonse,2009,9139,5873
Ursula,1980,1569,Ursula,2009,7445,5876
Jodie,1980,671,Jodie,2009,6549,5878
Delmar,1980,4082,Delmar,2009,9965,5883
Christen,1980,810,Christen,2009,6696,5886
Rahim,1980,2922,Rahim,2009,8813,5891
Gerry,1980,2597,Gerry,2009,8496,5899
Kristel,1980,2188,Kristel,2009,8091,5903
Zakiya,1980,2716,Zakiya,2009,8626,5910
Rae,1980,1771,Rae,2009,7683,5912
Ethel,1980,2323,Ethel,2009,8236,5913
Kedrick,1980,2592,Kedrick,2009,8511,5919
Socorro,1980,2014,Socorro,2009,7942,5928
Antwain,1980,2168,Antwain,2009,8102,5934
Garrick,1980,2537,Garrick,2009,8494,5957
Mitzi,1980,1929,Mitzi,2009,7915,5986
Rosanna,1980,1354,Rosanna,2009,7344,5990
Reza,1980,3704,Reza,2009,9716,6012
Kenisha,1980,1739,Kenisha,2009,7760,6021
Sanchez,1980,3856,Sanchez,2009,9885,6029
Jerrod,1980,954,Jerrod,2009,6992,6038
Greggory,1980,2453,Greggory,2009,8498,6045
Eboni,1980,1308,Eboni,2009,7357,6049
Reinaldo,1980,2063,Reinaldo,2009,8118,6055
Debbie,1980,787,Debbie,2009,6845,6058
Ed,1980,3764,Ed,2009,9823,6059
Demetra,1980,2175,Demetra,2009,8235,6060
Hermelinda,1980,3324,Hermelinda,2009,9385,6061
Marcy,1980,833,Marcy,2009,6897,6064
Geraldo,1980,2429,Geraldo,2009,8495,6066
Sarabeth,1980,2809,Sarabeth,2009,8913,6104
Enrico,1980,3523,Enrico,2009,9631,6108
Edgard,1980,3694,Edgard,2009,9824,6130
Terri,1980,464,Terri,2009,6643,6179
Rashid,1980,2661,Rashid,2009,8854,6193
Chrystal,1980,648,Chrystal,2009,6844,6196
Brie,1980,1977,Brie,2009,8173,6196
Valorie,1980,2901,Valorie,2009,9112,6211
Percy,1980,1828,Percy,2009,8055,6227
Gaspar,1980,3409,Gaspar,2009,9640,6231
Shauna,1980,434,Shauna,2009,6714,6280
Janee,1980,2425,Janee,2009,8715,6290
Galen,1980,1708,Galen,2009,8000,6292
Patrice,1980,659,Patrice,2009,6978,6319
Stevan,1980,2879,Stevan,2009,9227,6348
Maricella,1980,2715,Maricella,2009,9064,6349
Liset,1980,3096,Liset,2009,9447,6351
Seneca,1980,1571,Seneca,2009,7936,6365
Santa,1980,3154,Santa,2009,9519,6365
Pasquale,1980,2434,Pasquale,2009,8810,6376
Horace,1980,1746,Horace,2009,8131,6385
Charmaine,1980,1226,Charmaine,2009,7622,6396
Jaclynn,1980,2986,Jaclynn,2009,9394,6408
Latoya,1980,242,Latoya,2009,6683,6441
Cristine,1980,2892,Cristine,2009,9350,6458
Tabatha,1980,629,Tabatha,2009,7118,6489
Donta,1980,2060,Donta,2009,8596,6536
Scotty,1980,848,Scotty,2009,7395,6547
Dolly,1980,2807,Dolly,2009,9358,6551
Wilfred,1980,2257,Wilfred,2009,8824,6567
Candida,1980,2369,Candida,2009,8957,6588
Carisa,1980,2347,Carisa,2009,8959,6612
Ryanne,1980,2898,Ryanne,2009,9514,6616
Jess,1980,1111,Jess,2009,7728,6617
Russel,1980,2138,Russel,2009,8815,6677
Joni,1980,598,Joni,2009,7288,6690
Anjelica,1980,2622,Anjelica,2009,9315,6693
Myrna,1980,1748,Myrna,2009,8453,6705
Kay,1980,1717,Kay,2009,8430,6713
Garland,1980,2114,Garland,2009,8850,6736
Teresita,1980,2808,Teresita,2009,9545,6737
Woodrow,1980,2478,Woodrow,2009,9238,6760
Leslee,1980,2271,Leslee,2009,9047,6776
Boyd,1980,3035,Boyd,2009,9819,6784
Barton,1980,2360,Barton,2009,9149,6789
Donny,1980,1196,Donny,2009,7992,6796
Chastity,1980,1015,Chastity,2009,7832,6817
Nena,1980,2262,Nena,2009,9082,6820
Kasie,1980,2185,Kasie,2009,9023,6838
Jami,1980,516,Jami,2009,7361,6845
Evelia,1980,2487,Evelia,2009,9374,6887
Tiffanie,1980,802,Tiffanie,2009,7699,6897
Dannielle,1980,2421,Dannielle,2009,9353,6932
Deirdre,1980,1239,Deirdre,2009,8177,6938
Katina,1980,1299,Katina,2009,8247,6948
Nydia,1980,2106,Nydia,2009,9084,6978
Tad,1980,2736,Tad,2009,9739,7003
Teodoro,1980,2727,Teodoro,2009,9744,7017
Corrie,1980,1353,Corrie,2009,8391,7038
Jeannie,1980,799,Jeannie,2009,7873,7074
Darrick,1980,1404,Darrick,2009,8487,7083
Eldon,1980,2854,Eldon,2009,9966,7112
Rodriquez,1980,2754,Rodriquez,2009,9884,7130
Roscoe,1980,2591,Roscoe,2009,9722,7131
Lynsey,1980,2303,Lynsey,2009,9453,7150
Mandi,1980,734,Mandi,2009,7903,7169
Holli,1980,1236,Holli,2009,8409,7173
Ashli,1980,2668,Ashli,2009,9851,7183
Shanna,1980,346,Shanna,2009,7532,7186
Danial,1980,1949,Danial,2009,9163,7214
Noreen,1980,2234,Noreen,2009,9498,7264
Garry,1980,1033,Garry,2009,8339,7306
Polly,1980,2148,Polly,2009,9504,7356
Vicki,1980,913,Vicki,2009,8272,7359
Demetrios,1980,2580,Demetrios,2009,9942,7362
Long,1980,2307,Long,2009,9689,7382
Sedrick,1980,1770,Sedrick,2009,9224,7454
Reena,1980,2040,Reena,2009,9507,7467
Lowell,1980,2222,Lowell,2009,9690,7468
Sue,1980,981,Sue,2009,8468,7487
Akilah,1980,2278,Akilah,2009,9766,7488
Margie,1980,1533,Margie,2009,9061,7528
Patty,1980,1964,Patty,2009,9502,7538
Jesica,1980,1801,Jesica,2009,9410,7609
Torey,1980,2226,Torey,2009,9840,7614
Lupe,1980,1772,Lupe,2009,9452,7680
Leighann,1980,2167,Leighann,2009,9863,7696
Tasha,1980,250,Tasha,2009,7949,7699
Jeri,1980,1312,Jeri,2009,9011,7699
Lora,1980,743,Lora,2009,8444,7701
Brandie,1980,572,Brandie,2009,8382,7810
Rudolph,1980,1394,Rudolph,2009,9219,7825
Jeramy,1980,1355,Jeramy,2009,9183,7828
Bryon,1980,1007,Bryon,2009,8846,7839
Cari,1980,1108,Cari,2009,8958,7850
Cary,1980,1305,Cary,2009,9156,7851
Charissa,1980,1434,Charissa,2009,9346,7912
Cliff,1980,1870,Cliff,2009,9821,7951
Tramaine,1980,1883,Tramaine,2009,9841,7958
Nicholaus,1980,1743,Nicholaus,2009,9704,7961
Casie,1980,1360,Casie,2009,9344,7984
Quiana,1980,1073,Quiana,2009,9089,8016
Timmy,1980,1200,Timmy,2009,9230,8030
Jeannine,1980,1368,Jeannine,2009,9406,8038
Jo,1980,951,Jo,2009,9015,8064
Tarah,1980,1661,Tarah,2009,9812,8151
Kerri,1980,444,Kerri,2009,8723,8279
Cherie,1980,808,Cherie,2009,9347,8539
Tonia,1980,879,Tonia,2009,9548,8669
Rusty,1980,761,Rusty,2009,9724,8963
